player_name,total_value,common_value,uncommon_value,rare_value,epic_value,leg_value,mystic_value,iconic_value,
Shohei Ohtani,1340,1608,1876,2144,2680,3350,5360,8040,
Aaron Judge,1287,1544,1802,2059,2574,3218,5148,7722,
Juan Soto,1205,1446,1687,1928,2410,3013,4820,7230,
Francisco Lindor,1005,1206,1407,1608,2010,2513,4020,6030,
Jose Ramirez,986,1183,1380,1578,1972,2465,3944,5916,
Freddie Freeman,981,1177,1373,1570,1962,2453,3924,5886,
Emmanuel Clase,975,1170,1365,1560,1950,2438,3900,5850,
Tarik Skubal,964,1157,1350,1542,1928,2410,3856,5784,
Teoscar Hernandez,960,1152,1344,1536,1920,2400,3840,5760,
Pete Alonso,952,1142,1333,1523,1904,2380,3808,5712,
Bobby Witt Jr.,950,1140,1330,1520,1900,2375,3800,5700,
Mookie Betts,939,1127,1315,1502,1878,2348,3756,5634,
Mark Vientos,855,1026,1197,1368,1710,2138,3420,5130,
Giancarlo Stanton,851,1021,1191,1362,1702,2128,3404,5106,
Vladimir Guerrero Jr.,840,1008,1176,1344,1680,2100,3360,5040,
Kyle Schwarber,831,997,1163,1330,1662,2078,3324,4986,
Zack Wheeler,827,992,1158,1323,1654,2068,3308,4962,
Jackson Merrill,802,962,1123,1283,1604,2005,3208,4812,
Manny Machado,800,960,1120,1280,1600,2000,3200,4800,
Josh Naylor,799,959,1119,1278,1598,1998,3196,4794,
Ryan Helsley,795,954,1113,1272,1590,1988,3180,4770,
Gunnar Henderson,794,953,1112,1270,1588,1985,3176,4764,
Marcell Ozuna,792,950,1109,1267,1584,1980,3168,4752,
Bryce Harper,785,942,1099,1256,1570,1963,3140,4710,
Anthony Volpe,768,922,1075,1229,1536,1920,3072,4608,
Raisel Iglesias,767,920,1074,1227,1534,1918,3068,4602,
Willy Adames,763,916,1068,1221,1526,1908,3052,4578,
Sean Manaea,763,916,1068,1221,1526,1908,3052,4578,
Cole Ragans,762,914,1067,1219,1524,1905,3048,4572,
Gleyber Torres,761,913,1065,1218,1522,1903,3044,4566,
Yordan Alvarez,760,912,1064,1216,1520,1900,3040,4560,
Clay Holmes,758,910,1061,1213,1516,1895,3032,4548,
Jarren Duran,751,901,1051,1202,1502,1878,3004,4506,
Brent Rooker,750,900,1050,1200,1500,1875,3000,4500,
Brandon Nimmo,743,892,1040,1189,1486,1858,2972,4458,
Nick Castellanos,739,887,1035,1182,1478,1848,2956,4434,
Logan Gilbert,732,878,1025,1171,1464,1830,2928,4392,
Elly De La Cruz,724,869,1014,1158,1448,1810,2896,4344,
Jazz Chisholm Jr.,724,869,1014,1158,1448,1810,2896,4344,
Luke Weaver,719,863,1007,1150,1438,1798,2876,4314,
Jackson Chourio,718,862,1005,1149,1436,1795,2872,4308,
Anthony Santander,717,860,1004,1147,1434,1793,2868,4302,
Seth Lugo,714,857,1000,1142,1428,1785,2856,4284,
Ketel Marte,711,853,995,1138,1422,1778,2844,4266,
William Contreras,710,852,994,1136,1420,1775,2840,4260,
Michael King,709,851,993,1134,1418,1773,2836,4254,
Chris Sale,706,847,988,1130,1412,1765,2824,4236,
Corbin Burnes,705,846,987,1128,1410,1763,2820,4230,
Salvador Perez,698,838,977,1117,1396,1745,2792,4188,
Jack Flaherty,691,829,967,1106,1382,1728,2764,4146,
Robert Suarez,687,824,962,1099,1374,1718,2748,4122,
Tanner Scott,686,823,960,1098,1372,1715,2744,4116,
Dylan Cease,685,822,959,1096,1370,1713,2740,4110,
Jurickson Profar,684,821,958,1094,1368,1710,2736,4104,
Bryan Reynolds,683,820,956,1093,1366,1708,2732,4098,
Cade Smith,678,814,949,1085,1356,1695,2712,4068,
Matt Olson,675,810,945,1080,1350,1688,2700,4050,
Fernando Tatis Jr.,674,809,944,1078,1348,1685,2696,4044,
Eugenio Suarez,673,808,942,1077,1346,1683,2692,4038,
Corbin Carroll,668,802,935,1069,1336,1670,2672,4008,
Rafael Devers,667,800,934,1067,1334,1668,2668,4002,
Ezequiel Tovar,664,797,930,1062,1328,1660,2656,3984,
Lane Thomas,660,792,924,1056,1320,1650,2640,3960,
Carlos Rodon,657,788,920,1051,1314,1643,2628,3942,
Josh Hader,650,780,910,1040,1300,1625,2600,3900,
Matt Chapman,648,778,907,1037,1296,1620,2592,3888,
Riley Greene,645,774,903,1032,1290,1613,2580,3870,
Kyle Finnegan,635,762,889,1016,1270,1588,2540,3810,
Steven Kwan,635,762,889,1016,1270,1588,2540,3810,
Kirby Yates,634,761,888,1014,1268,1585,2536,3804,
Jose Altuve,634,761,888,1014,1268,1585,2536,3804,
Hunter Brown,634,761,888,1014,1268,1585,2536,3804,
Tyler Holton,633,760,886,1013,1266,1583,2532,3798,
Ian Happ,631,757,883,1010,1262,1578,2524,3786,
Vinnie Pasquantino,630,756,882,1008,1260,1575,2520,3780,
Jason Adam,629,755,881,1006,1258,1573,2516,3774,
Griffin Jax,628,754,879,1005,1256,1570,2512,3768,
Ryan Walker,627,752,878,1003,1254,1568,2508,3762,
Jesse Winker,626,751,876,1002,1252,1565,2504,3756,
Zach Neto,620,744,868,992,1240,1550,2480,3720,
Alex Bregman,620,744,868,992,1240,1550,2480,3720,
Yainer Diaz,620,744,868,992,1240,1550,2480,3720,
Alex Verdugo,620,744,868,992,1240,1550,2480,3720,
Framber Valdez,618,742,865,989,1236,1545,2472,3708,
Bailey Ober,617,740,864,987,1234,1543,2468,3702,
Cal Raleigh,616,739,862,986,1232,1540,2464,3696,
Spencer Steer,612,734,857,979,1224,1530,2448,3672,
Tanner Bibee,612,734,857,979,1224,1530,2448,3672,
Lucas Erceg,610,732,854,976,1220,1525,2440,3660,
Bryan Abreu,608,730,851,973,1216,1520,2432,3648,
Bryce Miller,606,727,848,970,1212,1515,2424,3636,
Logan Webb,605,726,847,968,1210,1513,2420,3630,
Oneil Cruz,602,722,843,963,1204,1505,2408,3612,
Aaron Nola,600,720,840,960,1200,1500,2400,3600,
Hunter Gaddis,600,720,840,960,1200,1500,2400,3600,
Luis Severino,600,720,840,960,1200,1500,2400,3600,
Seiya Suzuki,595,714,833,952,1190,1488,2380,3570,
Alec Bohm,595,714,833,952,1190,1488,2380,3570,
Trea Turner,595,714,833,952,1190,1488,2380,3570,
Cristopher Sanchez,593,712,830,949,1186,1483,2372,3558,
Alex Vesia,593,712,830,949,1186,1483,2372,3558,
Shota Imanaga,588,706,823,941,1176,1470,2352,3528,
Brenton Doyle,587,704,822,939,1174,1468,2348,3522,
Garrett Crochet,587,704,822,939,1174,1468,2348,3522,
Edwin Diaz,587,704,822,939,1174,1468,2348,3522,
Taylor Ward,585,702,819,936,1170,1463,2340,3510,
Masyn Winn,583,700,816,933,1166,1458,2332,3498,
Jake Cronenworth,583,700,816,933,1166,1458,2332,3498,
Jose Quintana,583,700,816,933,1166,1458,2332,3498,
Corey Seager,582,698,815,931,1164,1455,2328,3492,
Gerrit Cole,580,696,812,928,1160,1450,2320,3480,
Julio Rodriguez,579,695,811,926,1158,1448,2316,3474,
JJ Bleday,578,694,809,925,1156,1445,2312,3468,
Christian Walker,576,691,806,922,1152,1440,2304,3456,
Mason Miller,576,691,806,922,1152,1440,2304,3456,
Yusei Kikuchi,576,691,806,922,1152,1440,2304,3456,
Luis Arraez,576,691,806,922,1152,1440,2304,3456,
Marcus Semien,575,690,805,920,1150,1438,2300,3450,
Jason Foley,573,688,802,917,1146,1433,2292,3438,
Jorge Soler,573,688,802,917,1146,1433,2292,3438,
Brendan Donovan,569,683,797,910,1138,1423,2276,3414,
Evan Phillips,569,683,797,910,1138,1423,2276,3414,
Isaac Paredes,567,680,794,907,1134,1418,2268,3402,
George Kirby,566,679,792,906,1132,1415,2264,3396,
Paul Goldschmidt,566,679,792,906,1132,1415,2264,3396,
Cody Bellinger,565,678,791,904,1130,1413,2260,3390,
Freddy Peralta,562,674,787,899,1124,1405,2248,3372,
Brice Turang,562,674,787,899,1124,1405,2248,3372,
Will Vest,562,674,787,899,1124,1405,2248,3372,
Wyatt Langford,561,673,785,898,1122,1403,2244,3366,
Brandon Pfaadt,560,672,784,896,1120,1400,2240,3360,
CJ Abrams,560,672,784,896,1120,1400,2240,3360,
Max Fried,560,672,784,896,1120,1400,2240,3360,
Andres Gimenez,559,671,783,894,1118,1398,2236,3354,
Adolis Garcia,554,665,776,886,1108,1385,2216,3324,
Enrique Hernandez,554,665,776,886,1108,1385,2216,3324,
David Fry,553,664,774,885,1106,1383,2212,3318,
Ronel Blanco,552,662,773,883,1104,1380,2208,3312,
Michael Busch,550,660,770,880,1100,1375,2200,3300,
Jeff Hoffman,550,660,770,880,1100,1375,2200,3300,
Jeremy Pena,550,660,770,880,1100,1375,2200,3300,
Matt Vierling,550,660,770,880,1100,1375,2200,3300,
Jake Burger,549,659,769,878,1098,1373,2196,3294,
Pablo Lopez,547,656,766,875,1094,1368,2188,3282,
Paul Skenes,547,656,766,875,1094,1368,2188,3282,
Alec Burleson,545,654,763,872,1090,1363,2180,3270,
Michael Kopech,545,654,763,872,1090,1363,2180,3270,
Kenley Jansen,544,653,762,870,1088,1360,2176,3264,
Carlos Santana,543,652,760,869,1086,1358,2172,3258,
Gavin Lux,543,652,760,869,1086,1358,2172,3258,
Sonny Gray,541,649,757,866,1082,1353,2164,3246,
Dansby Swanson,540,648,756,864,1080,1350,2160,3240,
Maikel Garcia,540,648,756,864,1080,1350,2160,3240,
Aroldis Chapman,539,647,755,862,1078,1348,2156,3234,
Adley Rutschman,538,646,753,861,1076,1345,2152,3228,
Andrew Vaughn,538,646,753,861,1076,1345,2152,3228,
Hunter Greene,538,646,753,861,1076,1345,2152,3228,
Jonathan India,536,643,750,858,1072,1340,2144,3216,
Nolan Arenado,536,643,750,858,1072,1340,2144,3216,
Joe Jimenez,536,643,750,858,1072,1340,2144,3216,
Kevin Gausman,533,640,746,853,1066,1333,2132,3198,
Willi Castro,532,638,745,851,1064,1330,2128,3192,
David Robertson,531,637,743,850,1062,1328,2124,3186,
Nathaniel Lowe,531,637,743,850,1062,1328,2124,3186,
Yandy Diaz,531,637,743,850,1062,1328,2124,3186,
Colton Cowser,531,637,743,850,1062,1328,2124,3186,
Josh Bell,530,636,742,848,1060,1325,2120,3180,
Heliot Ramos,529,635,741,846,1058,1323,2116,3174,
Tanner Houck,529,635,741,846,1058,1323,2116,3174,
Luis Gil,528,634,739,845,1056,1320,2112,3168,
Starling Marte,528,634,739,845,1056,1320,2112,3168,
Colt Keith,526,631,736,842,1052,1315,2104,3156,
Josh Smith,525,630,735,840,1050,1313,2100,3150,
Nico Hoerner,525,630,735,840,1050,1313,2100,3150,
Luis Garcia Jr.,523,628,732,837,1046,1308,2092,3138,
Blake Treinen,522,626,731,835,1044,1305,2088,3132,
Jose Berrios,521,625,729,834,1042,1303,2084,3126,
Camilo Doval,520,624,728,832,1040,1300,2080,3120,
George Springer,518,622,725,829,1036,1295,2072,3108,
Randy Arozarena,517,620,724,827,1034,1293,2068,3102,
Tyler O'Neill,517,620,724,827,1034,1293,2068,3102,
Michael Wacha,517,620,724,827,1034,1293,2068,3102,
Nick Martinez,516,619,722,826,1032,1290,2064,3096,
Shea Langeliers,516,619,722,826,1032,1290,2064,3096,
Brady Singer,515,618,721,824,1030,1288,2060,3090,
Ryan McMahon,514,617,720,822,1028,1285,2056,3084,
Tyler Rogers,514,617,720,822,1028,1285,2056,3084,
Cedric Mullins,514,617,720,822,1028,1285,2056,3084,
Bryson Stott,514,617,720,822,1028,1285,2056,3084,
J.D. Martinez,514,617,720,822,1028,1285,2056,3084,
Andres Munoz,513,616,718,821,1026,1283,2052,3078,
Kutter Crawford,513,616,718,821,1026,1283,2052,3078,
Tyler Stephenson,513,616,718,821,1026,1283,2052,3078,
Carlos Estevez,513,616,718,821,1026,1283,2052,3078,
Ryne Stanek,513,616,718,821,1026,1283,2052,3078,
Tim Herrin,512,614,717,819,1024,1280,2048,3072,
Bryan De La Cruz,511,613,715,818,1022,1278,2044,3066,
Nathan Eovaldi,510,612,714,816,1020,1275,2040,3060,
Hector Neris,510,612,714,816,1020,1275,2040,3060,
Phil Maton,507,608,710,811,1014,1268,2028,3042,
Max Muncy,507,608,710,811,1014,1268,2028,3042,
Andrew Kittredge,506,607,708,810,1012,1265,2024,3036,
Jesus Sanchez,505,606,707,808,1010,1263,2020,3030,
Luis Castillo,505,606,707,808,1010,1263,2020,3030,
Nestor Cortes,505,606,707,808,1010,1263,2020,3030,
Joc Pederson,504,605,706,806,1008,1260,2016,3024,
Lourdes Gurriel Jr.,502,602,703,803,1004,1255,2008,3012,
Ceddanne Rafaela,501,601,701,802,1002,1253,2004,3006,
Tyler Glasnow,500,600,700,800,1000,1250,2000,3000,
Zach Eflin,499,599,699,798,998,1248,1996,2994,
Trevor Megill,499,599,699,798,998,1248,1996,2994,
MacKenzie Gore,497,596,696,795,994,1243,1988,2982,
Reynaldo Lopez,497,596,696,795,994,1243,1988,2982,
Austin Wells,497,596,696,795,994,1243,1988,2982,
Nolan Schanuel,494,593,692,790,988,1235,1976,2964,
Erick Fedde,492,590,689,787,984,1230,1968,2952,
Rhys Hoskins,492,590,689,787,984,1230,1968,2952,
Lawrence Butler,489,587,685,782,978,1223,1956,2934,
David Peterson,489,587,685,782,978,1223,1956,2934,
Kerry Carpenter,487,584,682,779,974,1218,1948,2922,
Yoshinobu Yamamoto,487,584,682,779,974,1218,1948,2922,
Jake Irvin,486,583,680,778,972,1215,1944,2916,
Ranger Suarez,486,583,680,778,972,1215,1944,2916,
Brendan Rodgers,483,580,676,773,966,1208,1932,2898,
Ryan O'Hearn,482,578,675,771,964,1205,1928,2892,
Andrew Benintendi,480,576,672,768,960,1200,1920,2880,
Daniel Hudson,479,575,671,766,958,1198,1916,2874,
Andrew Heaney,476,571,666,762,952,1190,1904,2856,
Michael Conforto,473,568,662,757,946,1183,1892,2838,
John Schreiber,473,568,662,757,946,1183,1892,2838,
Tommy Edman,473,568,662,757,946,1183,1892,2838,
Zack Littell,472,566,661,755,944,1180,1888,2832,
Tobias Myers,472,566,661,755,944,1180,1888,2832,
Michael Harris II,472,566,661,755,944,1180,1888,2832,
Craig Kimbrel,471,565,659,754,942,1178,1884,2826,
Jhoan Duran,471,565,659,754,942,1178,1884,2826,
Chris Bassitt,469,563,657,750,938,1173,1876,2814,
Kevin Ginkel,468,562,655,749,936,1170,1872,2808,
Mike Yastrzemski,467,560,654,747,934,1168,1868,2802,
Zac Gallen,467,560,654,747,934,1168,1868,2802,
Luke Raley,466,559,652,746,932,1165,1864,2796,
Mitch Keller,466,559,652,746,932,1165,1864,2796,
Wilyer Abreu,466,559,652,746,932,1165,1864,2796,
Jake McCarthy,465,558,651,744,930,1163,1860,2790,
Derek Law,464,557,650,742,928,1160,1856,2784,
Kyle Gibson,464,557,650,742,928,1160,1856,2784,
Luis L. Ortiz,463,556,648,741,926,1158,1852,2778,
Joel Payamps,463,556,648,741,926,1158,1852,2778,
Alexis Diaz,461,553,645,738,922,1153,1844,2766,
Charlie Morton,461,553,645,738,922,1153,1844,2766,
Spencer Arrighetti,461,553,645,738,922,1153,1844,2766,
Tyler Kinley,461,553,645,738,922,1153,1844,2766,
Andy Pages,460,552,644,736,920,1150,1840,2760,
Jameson Taillon,458,550,641,733,916,1145,1832,2748,
Ryan Mountcastle,457,548,640,731,914,1143,1828,2742,
Daulton Varsho,454,545,636,726,908,1135,1816,2724,
Fernando Cruz,454,545,636,726,908,1135,1816,2724,
JP Sears,454,545,636,726,908,1135,1816,2724,
Joe Ryan,454,545,636,726,908,1135,1816,2724,
Brandon Marsh,453,544,634,725,906,1133,1812,2718,
Austin Riley,450,540,630,720,900,1125,1800,2700,
Joey Ortiz,449,539,629,718,898,1123,1796,2694,
Justin Steele,449,539,629,718,898,1123,1796,2694,
Dylan Floro,448,538,627,717,896,1120,1792,2688,
Logan O'Hoppe,448,538,627,717,896,1120,1792,2688,
Robert Garcia,448,538,627,717,896,1120,1792,2688,
Jordan Westburg,448,538,627,717,896,1120,1792,2688,
Xander Bogaerts,448,538,627,717,896,1120,1792,2688,
Brayan Bello,445,534,623,712,890,1113,1780,2670,
Colin Rea,445,534,623,712,890,1113,1780,2670,
Andrew McCutchen,444,533,622,710,888,1110,1776,2664,
Nick Pivetta,444,533,622,710,888,1110,1776,2664,
Byron Buxton,443,532,620,709,886,1108,1772,2658,
Christopher Morel,443,532,620,709,886,1108,1772,2658,
Keegan Akin,443,532,620,709,886,1108,1772,2658,
Aaron Civale,443,532,620,709,886,1108,1772,2658,
A.J. Puk,441,529,617,706,882,1103,1764,2646,
Justin Turner,441,529,617,706,882,1103,1764,2646,
Taj Bradley,441,529,617,706,882,1103,1764,2646,
Brayan Rocchio,440,528,616,704,880,1100,1760,2640,
Connor Wong,437,524,612,699,874,1093,1748,2622,
Carlos Correa,436,523,610,698,872,1090,1744,2616,
Mitchell Parker,436,523,610,698,872,1090,1744,2616,
Frankie Montas,436,523,610,698,872,1090,1744,2616,
Blake Snell,435,522,609,696,870,1088,1740,2610,
Michael Toglia,435,522,609,696,870,1088,1740,2610,
Tyler Anderson,435,522,609,696,870,1088,1740,2610,
Tommy Pham,435,522,609,696,870,1088,1740,2610,
Pete Fairbanks,432,518,605,691,864,1080,1728,2592,
Jose Alvarado,431,517,603,690,862,1078,1724,2586,
Leody Taveras,431,517,603,690,862,1078,1724,2586,
Scott Barlow,431,517,603,690,862,1078,1724,2586,
Ryne Nelson,429,515,601,686,858,1073,1716,2574,
Ty France,428,514,599,685,856,1070,1712,2568,
Charlie Blackmon,427,512,598,683,854,1068,1708,2562,
MJ Melendez,427,512,598,683,854,1068,1708,2562,
Reese Olson,425,510,595,680,850,1063,1700,2550,
Brandon Lowe,423,508,592,677,846,1058,1692,2538,
Kyle Isbel,423,508,592,677,846,1058,1692,2538,
Jo Adell,422,506,591,675,844,1055,1688,2532,
Kyle Tucker,422,506,591,675,844,1055,1688,2532,
Paul DeJong,420,504,588,672,840,1050,1680,2520,
Ryan Feltner,420,504,588,672,840,1050,1680,2520,
Orlando Arcia,420,504,588,672,840,1050,1680,2520,
Harrison Bader,420,504,588,672,840,1050,1680,2520,
Dennis Santana,419,503,587,670,838,1048,1676,2514,
Ernie Clement,419,503,587,670,838,1048,1676,2514,
David Bednar,418,502,585,669,836,1045,1672,2508,
Sal Frelick,418,502,585,669,836,1045,1672,2508,
Garrett Cleavinger,417,500,584,667,834,1043,1668,2502,
Ryan Jeffers,417,500,584,667,834,1043,1668,2502,
Jeff McNeil,417,500,584,667,834,1043,1668,2502,
Masataka Yoshida,416,499,582,666,832,1040,1664,2496,
Jeimer Candelario,415,498,581,664,830,1038,1660,2490,
Ryan Pepiot,415,498,581,664,830,1038,1660,2490,
Mark Leiter Jr.,415,498,581,664,830,1038,1660,2490,
Jake Meyers,414,497,580,662,828,1035,1656,2484,
Yennier Cano,412,494,577,659,824,1030,1648,2472,
Matt Strahm,412,494,577,659,824,1030,1648,2472,
Zack Gelof,411,493,575,658,822,1028,1644,2466,
Reed Garrett,409,491,573,654,818,1023,1636,2454,
Chad Green,408,490,571,653,816,1020,1632,2448,
Seranthony Dominguez,407,488,570,651,814,1018,1628,2442,
Bryan Woo,406,487,568,650,812,1015,1624,2436,
Matthew Liberatore,406,487,568,650,812,1015,1624,2436,
Francisco Alvarez,406,487,568,650,812,1015,1624,2436,
Tommy Kahnle,403,484,564,645,806,1008,1612,2418,
Austin Gomber,401,481,561,642,802,1003,1604,2406,
Ryan Thompson,400,480,560,640,800,1000,1600,2400,
Jeremiah Estrada,400,480,560,640,800,1000,1600,2400,
Kyle Higashioka,400,480,560,640,800,1000,1600,2400,
Gavin Stone,399,479,559,638,798,998,1596,2394,
Tim Hill,399,479,559,638,798,998,1596,2394,
Yu Darvish,399,479,559,638,798,998,1596,2394,
Justin Martinez,398,478,557,637,796,995,1592,2388,
Patrick Corbin,397,476,556,635,794,993,1588,2382,
Jose Miranda,396,475,554,634,792,990,1584,2376,
Kevin Kelly,395,474,553,632,790,988,1580,2370,
Miles Mikolas,395,474,553,632,790,988,1580,2370,
Michael Massey,395,474,553,632,790,988,1580,2370,
Andre Pallante,393,472,550,629,786,983,1572,2358,
Ha-Seong Kim,393,472,550,629,786,983,1572,2358,
Isiah Kiner-Falefa,393,472,550,629,786,983,1572,2358,
Jonah Heim,393,472,550,629,786,983,1572,2358,
Jose Caballero,393,472,550,629,786,983,1572,2358,
Spencer Schwellenbach,392,470,549,627,784,980,1568,2352,
Trevor Larnach,391,469,547,626,782,978,1564,2346,
Hunter Strickland,390,468,546,624,780,975,1560,2340,
JoJo Romero,388,466,543,621,776,970,1552,2328,
Jose Leclerc,388,466,543,621,776,970,1552,2328,
Albert Suarez,387,464,542,619,774,968,1548,2322,
Cole Sands,387,464,542,619,774,968,1548,2322,
Beau Brieske,387,464,542,619,774,968,1548,2322,
Joe Mantiply,386,463,540,618,772,965,1544,2316,
Jose Siri,386,463,540,618,772,965,1544,2316,
Angel Zerpa,386,463,540,618,772,965,1544,2316,
Jarred Kelenic,385,462,539,616,770,963,1540,2310,
Mitch Spence,385,462,539,616,770,963,1540,2310,
Wenceel Perez,385,462,539,616,770,963,1540,2310,
Dean Kremer,384,461,538,614,768,960,1536,2304,
Nick Mears,384,461,538,614,768,960,1536,2304,
Hunter Renfroe,382,458,535,611,764,955,1528,2292,
Javier Assad,382,458,535,611,764,955,1528,2292,
Ozzie Albies,382,458,535,611,764,955,1528,2292,
Parker Meadows,380,456,532,608,760,950,1520,2280,
Seth Brown,379,455,531,606,758,948,1516,2274,
Gregory Soto,379,455,531,606,758,948,1516,2274,
Aaron Bummer,379,455,531,606,758,948,1516,2274,
T.J. McFarland,377,452,528,603,754,943,1508,2262,
Pete Crow-Armstrong,376,451,526,602,752,940,1504,2256,
Rowdy Tellez,376,451,526,602,752,940,1504,2256,
Blake Perkins,376,451,526,602,752,940,1504,2256,
Keibert Ruiz,375,450,525,600,750,938,1500,2250,
Lars Nootbaar,374,449,524,598,748,935,1496,2244,
J.T. Realmuto,374,449,524,598,748,935,1496,2244,
Ben Lively,374,449,524,598,748,935,1496,2244,
Griffin Canning,373,448,522,597,746,933,1492,2238,
Jorge Polanco,373,448,522,597,746,933,1492,2238,
Dylan Moore,372,446,521,595,744,930,1488,2232,
Nate Pearson,372,446,521,595,744,930,1488,2232,
Anthony Banda,372,446,521,595,744,930,1488,2232,
Jacob Young,371,445,519,594,742,928,1484,2226,
Jose Soriano,371,445,519,594,742,928,1484,2226,
Ryan Pressly,371,445,519,594,742,928,1484,2226,
Joe Musgrove,371,445,519,594,742,928,1484,2226,
Spencer Torkelson,371,445,519,594,742,928,1484,2226,
Bowden Francis,369,443,517,590,738,923,1476,2214,
Mickey Moniak,369,443,517,590,738,923,1476,2214,
Mauricio Dubon,369,443,517,590,738,923,1476,2214,
Orion Kerkering,369,443,517,590,738,923,1476,2214,
Gavin Sheets,368,442,515,589,736,920,1472,2208,
LaMonte Wade Jr.,368,442,515,589,736,920,1472,2208,
Tayler Scott,368,442,515,589,736,920,1472,2208,
James McArthur,367,440,514,587,734,918,1468,2202,
Taylor Rogers,367,440,514,587,734,918,1468,2202,
Michael Lorenzen,367,440,514,587,734,918,1468,2202,
Will Smith,367,440,514,587,734,918,1468,2202,
Jon Singleton,365,438,511,584,730,913,1460,2190,
Trent Thornton,364,437,510,582,728,910,1456,2184,
Pierce Johnson,364,437,510,582,728,910,1456,2184,
Erik Miller,363,436,508,581,726,908,1452,2178,
Simeon Woods Richardson,362,434,507,579,724,905,1448,2172,
Victor Vodnik,362,434,507,579,724,905,1448,2172,
Tyrone Taylor,362,434,507,579,724,905,1448,2172,
Spencer Horwitz,361,433,505,578,722,903,1444,2166,
Matt Waldron,359,431,503,574,718,898,1436,2154,
Michael Tonkin,359,431,503,574,718,898,1436,2154,
Christian Yelich,358,430,501,573,716,895,1432,2148,
Trevor Richards,357,428,500,571,714,893,1428,2142,
Jacob Webb,357,428,500,571,714,893,1428,2142,
Gio Urshela,356,427,498,570,712,890,1424,2136,
Grayson Rodriguez,356,427,498,570,712,890,1424,2136,
Bryan Hudson,355,426,497,568,710,888,1420,2130,
Otto Lopez,355,426,497,568,710,888,1420,2130,
Yuki Matsui,355,426,497,568,710,888,1420,2130,
Andrew Abbott,354,425,496,566,708,885,1416,2124,
Jared Jones,354,425,496,566,708,885,1416,2124,
Jorge Lopez,354,425,496,566,708,885,1416,2124,
Mitch Garver,354,425,496,566,708,885,1416,2124,
Bailey Falter,353,424,494,565,706,883,1412,2118,
Jalen Beeks,352,422,493,563,704,880,1408,2112,
Jose Butto,351,421,491,562,702,878,1404,2106,
Alejandro Kirk,350,420,490,560,700,875,1400,2100,
Geraldo Perdomo,350,420,490,560,700,875,1400,2100,
Anthony Rizzo,350,420,490,560,700,875,1400,2100,
Nolan Gorman,348,418,487,557,696,870,1392,2088,
Pedro Avila,348,418,487,557,696,870,1392,2088,
Jake Rogers,348,418,487,557,696,870,1392,2088,
John Brebbia,347,416,486,555,694,868,1388,2082,
Marcus Stroman,347,416,486,555,694,868,1388,2082,
Caleb Ferguson,347,416,486,555,694,868,1388,2082,
Adam Ottavino,346,415,484,554,692,865,1384,2076,
Andrew Chafin,346,415,484,554,692,865,1384,2076,
Anthony Bender,345,414,483,552,690,863,1380,2070,
Josh Rojas,345,414,483,552,690,863,1380,2070,
Andrew Nardi,342,410,479,547,684,855,1368,2052,
Willson Contreras,342,410,479,547,684,855,1368,2052,
Luis Robert Jr.,341,409,477,546,682,853,1364,2046,
Tanner Banks,341,409,477,546,682,853,1364,2046,
Bo Naylor,341,409,477,546,682,853,1364,2046,
Hoby Milner,340,408,476,544,680,850,1360,2040,
Nick Gonzales,340,408,476,544,680,850,1360,2040,
Jared Triolo,339,407,475,542,678,848,1356,2034,
Randal Grichuk,339,407,475,542,678,848,1356,2034,
Ryan Yarbrough,339,407,475,542,678,848,1356,2034,
Chris Flexen,337,404,472,539,674,843,1348,2022,
Davis Schneider,337,404,472,539,674,843,1348,2022,
Kyle Harrison,337,404,472,539,674,843,1348,2022,
Patrick Bailey,337,404,472,539,674,843,1348,2022,
Tyler Fitzgerald,337,404,472,539,674,843,1348,2022,
Mark Canha,336,403,470,538,672,840,1344,2016,
Nick Sandlin,336,403,470,538,672,840,1344,2016,
Cionel Perez,335,402,469,536,670,838,1340,2010,
Genesis Cabrera,335,402,469,536,670,838,1340,2010,
Alec Marsh,334,401,468,534,668,835,1336,2004,
Max Schuemann,334,401,468,534,668,835,1336,2004,
Clarke Schmidt,333,400,466,533,666,833,1332,1998,
Justin Wilson,332,398,465,531,664,830,1328,1992,
Jake Bauers,332,398,465,531,664,830,1328,1992,
Josh Lowe,330,396,462,528,660,825,1320,1980,
Nick Lodolo,330,396,462,528,660,825,1320,1980,
Colin Holderman,329,395,461,526,658,823,1316,1974,
J.P. Crawford,328,394,459,525,656,820,1312,1968,
Nicky Lopez,328,394,459,525,656,820,1312,1968,
Paul Sewald,328,394,459,525,656,820,1312,1968,
Buck Farmer,327,392,458,523,654,818,1308,1962,
Luis Garcia,326,391,456,522,652,815,1304,1956,
Will Benson,326,391,456,522,652,815,1304,1956,
Caleb Thielbar,325,390,455,520,650,813,1300,1950,
Declan Cronin,324,389,454,518,648,810,1296,1944,
Gabriel Moreno,324,389,454,518,648,810,1296,1944,
Santiago Espinal,324,389,454,518,648,810,1296,1944,
James Wood,323,388,452,517,646,808,1292,1938,
Ryan Fernandez,323,388,452,517,646,808,1292,1938,
Travis d'Arnaud,323,388,452,517,646,808,1292,1938,
Miguel Amaya,322,386,451,515,644,805,1288,1932,
Calvin Faucher,321,385,449,514,642,803,1284,1926,
Jose Iglesias,320,384,448,512,640,800,1280,1920,
Jake Cave,319,383,447,510,638,798,1276,1914,
Mitch Haniger,319,383,447,510,638,798,1276,1914,
David Peralta,318,382,445,509,636,795,1272,1908,
Connor Joe,317,380,444,507,634,793,1268,1902,
Lance Lynn,317,380,444,507,634,793,1268,1902,
Martin Perez,317,380,444,507,634,793,1268,1902,
Victor Robles,317,380,444,507,634,793,1268,1902,
TJ Friedl,316,379,442,506,632,790,1264,1896,
Ramon Urias,316,379,442,506,632,790,1264,1896,
Xavier Edwards,315,378,441,504,630,788,1260,1890,
Joey Estes,314,377,440,502,628,785,1256,1884,
Jose Urena,314,377,440,502,628,785,1256,1884,
Max Kepler,314,377,440,502,628,785,1256,1884,
Rob Refsnyder,314,377,440,502,628,785,1256,1884,
Zach McKinstry,314,377,440,502,628,785,1256,1884,
Jon Gray,313,376,438,501,626,783,1252,1878,
Will Brennan,313,376,438,501,626,783,1252,1878,
Greg Weissert,312,374,437,499,624,780,1248,1872,
Tyler Ferguson,312,374,437,499,624,780,1248,1872,
Hunter Harvey,311,373,435,498,622,778,1244,1866,
Korey Lee,311,373,435,498,622,778,1244,1866,
Sean Hjelle,310,372,434,496,620,775,1240,1860,
Kyle Hendricks,309,371,433,494,618,773,1236,1854,
Luke Jackson,309,371,433,494,618,773,1236,1854,
Jorge Alcala,307,368,430,491,614,768,1228,1842,
Ramon Laureano,307,368,430,491,614,768,1228,1842,
Royce Lewis,307,368,430,491,614,768,1228,1842,
Enyel De Los Santos,306,367,428,490,612,765,1224,1836,
Thairo Estrada,306,367,428,490,612,765,1224,1836,
Chris Martin,305,366,427,488,610,763,1220,1830,
Elias Diaz,305,366,427,488,610,763,1220,1830,
Donovan Solano,305,366,427,488,610,763,1220,1830,
Luis Rengifo,303,364,424,485,606,758,1212,1818,
Tyson Miller,303,364,424,485,606,758,1212,1818,
Jared Koenig,303,364,424,485,606,758,1212,1818,
Austin Voth,302,362,423,483,604,755,1208,1812,
Edward Cabrera,302,362,423,483,604,755,1208,1812,
Dylan Lee,302,362,423,483,604,755,1208,1812,
Walker Buehler,302,362,423,483,604,755,1208,1812,
Porter Hodge,301,361,421,482,602,753,1204,1806,
Carson Fulmer,300,360,420,480,600,750,1200,1800,
Freddy Fermin,298,358,417,477,596,745,1192,1788,
Jake Fraley,298,358,417,477,596,745,1192,1788,
Mike Tauchman,298,358,417,477,596,745,1192,1788,
Joey Wentz,297,356,416,475,594,743,1188,1782,
Miguel Rojas,297,356,416,475,594,743,1188,1782,
Bryse Wilson,294,353,412,470,588,735,1176,1764,
Tim Mayza,293,352,410,469,586,733,1172,1758,
Austin Adams,292,350,409,467,584,730,1168,1752,
David Hamilton,292,350,409,467,584,730,1168,1752,
Lenyn Sosa,292,350,409,467,584,730,1168,1752,
John King,291,349,407,466,582,728,1164,1746,
Jesse Chavez,291,349,407,466,582,728,1164,1746,
Lucas Sims,289,347,405,462,578,723,1156,1734,
Manuel Rodriguez,289,347,405,462,578,723,1156,1734,
Garrett Mitchell,289,347,405,462,578,723,1156,1734,
Adrian Morejon,286,343,400,458,572,715,1144,1716,
Cal Quantrill,285,342,399,456,570,713,1140,1710,
Joey Bart,285,342,399,456,570,713,1140,1710,
Jonah Bride,285,342,399,456,570,713,1140,1710,
Johan Rojas,285,342,399,456,570,713,1140,1710,
Yimi Garcia,284,341,398,454,568,710,1136,1704,
Matt Wallner,283,340,396,453,566,708,1132,1698,
Roansy Contreras,281,337,393,450,562,703,1124,1686,
Chris Stratton,280,336,392,448,560,700,1120,1680,
Jakob Junis,280,336,392,448,560,700,1120,1680,
Amed Rosario,279,335,391,446,558,698,1116,1674,
Justin Anderson,277,332,388,443,554,693,1108,1662,
Colin Poche,276,331,386,442,552,690,1104,1656,
Jacob Barnes,276,331,386,442,552,690,1104,1656,
Jonathan Cannon,274,329,384,438,548,685,1096,1644,
Ryan Weathers,274,329,384,438,548,685,1096,1644,
Trevor Rogers,274,329,384,438,548,685,1096,1644,
Jordan Hicks,273,328,382,437,546,683,1092,1638,
Kevin Pillar,273,328,382,437,546,683,1092,1638,
Devin Williams,273,328,382,437,546,683,1092,1638,
Eli Morgan,273,328,382,437,546,683,1092,1638,
Mike Baumann,271,325,379,434,542,678,1084,1626,
Sam Long,271,325,379,434,542,678,1084,1626,
Justin Lawrence,270,324,378,432,540,675,1080,1620,
Tyler Freeman,270,324,378,432,540,675,1080,1620,
DJ Herz,269,323,377,430,538,673,1076,1614,
Oswaldo Cabrera,267,320,374,427,534,668,1068,1602,
Andy Ibanez,267,320,374,427,534,668,1068,1602,
Cooper Criswell,266,319,372,426,532,665,1064,1596,
Emmanuel Rivera,266,319,372,426,532,665,1064,1596,
Sam Moll,266,319,372,426,532,665,1064,1596,
Manuel Margot,265,318,371,424,530,663,1060,1590,
Shelby Miller,265,318,371,424,530,663,1060,1590,
Gary Sanchez,265,318,371,424,530,663,1060,1590,
Brent Suter,264,317,370,422,528,660,1056,1584,
Landon Knack,264,317,370,422,528,660,1056,1584,
Jacob Stallings,263,316,368,421,526,658,1052,1578,
Dominic Smith,262,314,367,419,524,655,1048,1572,
James Paxton,262,314,367,419,524,655,1048,1572,
Kenta Maeda,262,314,367,419,524,655,1048,1572,
Shawn Armstrong,262,314,367,419,524,655,1048,1572,
Matthew Boyd,262,314,367,419,524,655,1048,1572,
Abraham Toro,260,312,364,416,520,650,1040,1560,
Justin Slaten,260,312,364,416,520,650,1040,1560,
Tyler Alexander,259,311,363,414,518,648,1036,1554,
Edmundo Sosa,259,311,363,414,518,648,1036,1554,
Tylor Megill,259,311,363,414,518,648,1036,1554,
Brennan Bernardino,257,308,360,411,514,643,1028,1542,
Hunter Stratton,257,308,360,411,514,643,1028,1542,
Kevin Newman,257,308,360,411,514,643,1028,1542,
Shane Baz,257,308,360,411,514,643,1028,1542,
Zack Kelly,257,308,360,411,514,643,1028,1542,
Grant Holmes,256,307,358,410,512,640,1024,1536,
Ivan Herrera,256,307,358,410,512,640,1024,1536,
Tanner Rainey,256,307,358,410,512,640,1024,1536,
Zach Pop,256,307,358,410,512,640,1024,1536,
Jhonkensy Noel,255,306,357,408,510,638,1020,1530,
Carson Kelly,254,305,356,406,508,635,1016,1524,
Jason Heyward,254,305,356,406,508,635,1016,1524,
Burch Smith,252,302,353,403,504,630,1008,1512,
Randy Vasquez,252,302,353,403,504,630,1008,1512,
Triston Casas,252,302,353,403,504,630,1008,1512,
Cody Bradford,251,301,351,402,502,628,1004,1506,
Luis Campusano,250,300,350,400,500,625,1000,1500,
Edwin Uceta,249,299,349,398,498,623,996,1494,
Kyle Nicolas,248,298,347,397,496,620,992,1488,
Alex Faedo,247,296,346,395,494,618,988,1482,
Cole Irvin,247,296,346,395,494,618,988,1482,
Jonny DeLuca,247,296,346,395,494,618,988,1482,
Joey Meneses,245,294,343,392,490,613,980,1470,
Kyle Freeland,244,293,342,390,488,610,976,1464,
Danny Coulombe,244,293,342,390,488,610,976,1464,
Jake Cousins,244,293,342,390,488,610,976,1464,
Casey Mize,243,292,340,389,486,608,972,1458,
Jordan Montgomery,243,292,340,389,486,608,972,1458,
Jesus Tinoco,242,290,339,387,484,605,968,1452,
Michel Otanez,241,289,337,386,482,603,964,1446,
Romy Gonzalez,241,289,337,386,482,603,964,1446,
Chris Paddack,240,288,336,384,480,600,960,1440,
Whit Merrifield,238,286,333,381,476,595,952,1428,
Ildemaro Vargas,237,284,332,379,474,593,948,1422,
Keider Montero,237,284,332,379,474,593,948,1422,
Bo Bichette,236,283,330,378,472,590,944,1416,
Richie Palacios,236,283,330,378,472,590,944,1416,
Trevor Williams,236,283,330,378,472,590,944,1416,
Adam Duvall,235,282,329,376,470,588,940,1410,
Matt Moore,235,282,329,376,470,588,940,1410,
Michael Soroka,235,282,329,376,470,588,940,1410,
Miguel Andujar,235,282,329,376,470,588,940,1410,
Joe Ross,235,282,329,376,470,588,940,1410,
Danny Jansen,234,281,328,374,468,585,936,1404,
Eloy Jimenez,234,281,328,374,468,585,936,1404,
Ben Rortvedt,233,280,326,373,466,583,932,1398,
Juan Yepez,233,280,326,373,466,583,932,1398,
Ke'Bryan Hayes,233,280,326,373,466,583,932,1398,
Patrick Sandoval,233,280,326,373,466,583,932,1398,
Victor Caratini,232,278,325,371,464,580,928,1392,
Ben Brown,231,277,323,370,462,578,924,1386,
Elvis Peguero,231,277,323,370,462,578,924,1386,
Emilio Pagan,231,277,323,370,462,578,924,1386,
Erik Swanson,231,277,323,370,462,578,924,1386,
Nick Fortes,231,277,323,370,462,578,924,1386,
Michael Siani,230,276,322,368,460,575,920,1380,
A.J. Minter,229,275,321,366,458,573,916,1374,
Osvaldo Bido,228,274,319,365,456,570,912,1368,
Garrett Hampson,228,274,319,365,456,570,912,1368,
Collin Snider,227,272,318,363,454,568,908,1362,
Jake Diekman,227,272,318,363,454,568,908,1362,
Javier Baez,227,272,318,363,454,568,908,1362,
Danny Young,227,272,318,363,454,568,908,1362,
Jacob Latz,226,271,316,362,452,565,904,1356,
Ryan Brasier,226,271,316,362,452,565,904,1356,
Eddie Rosario,225,270,315,360,450,563,900,1350,
Landen Roupp,225,270,315,360,450,563,900,1350,
Yariel Rodriguez,225,270,315,360,450,563,900,1350,
Kyle Manzardo,225,270,315,360,450,563,900,1350,
Brendon Little,224,269,314,358,448,560,896,1344,
Rafael Montero,224,269,314,358,448,560,896,1344,
Kris Bubic,224,269,314,358,448,560,896,1344,
Drew Smyly,223,268,312,357,446,558,892,1338,
Hayden Wesneski,223,268,312,357,446,558,892,1338,
Reid Detmers,223,268,312,357,446,558,892,1338,
Adam Frazier,223,268,312,357,446,558,892,1338,
Cam Booser,222,266,311,355,444,555,888,1332,
Kevin Kiermaier,222,266,311,355,444,555,888,1332,
Chris Taylor,222,266,311,355,444,555,888,1332,
Gavin Williams,221,265,309,354,442,553,884,1326,
Josh Winckowski,221,265,309,354,442,553,884,1326,
Randy Rodriguez,221,265,309,354,442,553,884,1326,
Tayler Saucedo,220,264,308,352,440,550,880,1320,
Yohan Ramirez,220,264,308,352,440,550,880,1320,
Stephen Kolek,219,263,307,350,438,548,876,1314,
Dedniel Nunez,218,262,305,349,436,545,872,1308,
Stuart Fairchild,218,262,305,349,436,545,872,1308,
Ben Joyce,217,260,304,347,434,543,868,1302,
Michael Grove,217,260,304,347,434,543,868,1302,
Nick Gordon,217,260,304,347,434,543,868,1302,
Huascar Brazoban,216,259,302,346,432,540,864,1296,
Jose Trevino,216,259,302,346,432,540,864,1296,
Scott Alexander,215,258,301,344,430,538,860,1290,
Carmen Mlodzinski,214,257,300,342,428,535,856,1284,
Christian Vazquez,214,257,300,342,428,535,856,1284,
Jose Ruiz,214,257,300,342,428,535,856,1284,
Nolan Jones,214,257,300,342,428,535,856,1284,
Austin Hays,213,256,298,341,426,533,852,1278,
Hayden Birdsong,213,256,298,341,426,533,852,1278,
Pavin Smith,212,254,297,339,424,530,848,1272,
Bryan Hoeing,212,254,297,339,424,530,848,1272,
Brett Wisely,211,253,295,338,422,528,844,1266,
James McCann,211,253,295,338,422,528,844,1266,
Nick Anderson,211,253,295,338,422,528,844,1266,
Bryce Jarvis,210,252,294,336,420,525,840,1260,
Carlos Carrasco,210,252,294,336,420,525,840,1260,
Yasmani Grandal,210,252,294,336,420,525,840,1260,
Justyn-Henry Malloy,210,252,294,336,420,525,840,1260,
Hunter Goodman,209,251,293,334,418,523,836,1254,
Jose Suarez,209,251,293,334,418,523,836,1254,
Justin Verlander,209,251,293,334,418,523,836,1254,
Wandy Peralta,208,250,291,333,416,520,832,1248,
Willie Calhoun,207,248,290,331,414,518,828,1242,
Vidal Brujan,206,247,288,330,412,515,824,1236,
Edouard Julien,205,246,287,328,410,513,820,1230,
Ezequiel Duran,205,246,287,328,410,513,820,1230,
Jack Suwinski,205,246,287,328,410,513,820,1230,
Cade Povich,203,244,284,325,406,508,812,1218,
Joe Kelly,203,244,284,325,406,508,812,1218,
Dane Dunning,202,242,283,323,404,505,808,1212,
JT Chargois,202,242,283,323,404,505,808,1212,
Jesus Luzardo,202,242,283,323,404,505,808,1212,
Ian Hamilton,202,242,283,323,404,505,808,1212,
Joey Gallo,201,241,281,322,402,503,804,1206,
Austin Martin,200,240,280,320,400,500,800,1200,
Jose A. Ferrer,200,240,280,320,400,500,800,1200,
Kyle Farmer,200,240,280,320,400,500,800,1200,
Sean Murphy,200,240,280,320,400,500,800,1200,
Hogan Harris,199,239,279,318,398,498,796,1194,
Chas McCormick,199,239,279,318,398,498,796,1194,
Harold Ramirez,198,238,277,317,396,495,792,1188,
Joey Loperfido,198,238,277,317,396,495,792,1188,
Brant Hurter,198,238,277,317,396,495,792,1188,
Merrill Kelly,197,236,276,315,394,493,788,1182,
Nelson Velazquez,197,236,276,315,394,493,788,1182,
Spencer Turnbull,197,236,276,315,394,493,788,1182,
Trent Grisham,196,235,274,314,392,490,784,1176,
Jared Shuster,195,234,273,312,390,488,780,1170,
Seth Martinez,194,233,272,310,388,485,776,1164,
Tyler Soderstrom,194,233,272,310,388,485,776,1164,
Ross Stripling,193,232,270,309,386,483,772,1158,
Chase Anderson,192,230,269,307,384,480,768,1152,
Dylan Carlson,192,230,269,307,384,480,768,1152,
Carson Spiers,191,229,267,306,382,478,764,1146,
Paul Blackburn,191,229,267,306,382,478,764,1146,
Pedro Pages,191,229,267,306,382,478,764,1146,
Michael A. Taylor,190,228,266,304,380,475,760,1140,
Tyler Nevin,189,227,265,302,378,473,756,1134,
Connor Norby,188,226,263,301,376,470,752,1128,
Enmanuel Valdez,188,226,263,301,376,470,752,1128,
Jordan Weems,187,224,262,299,374,468,748,1122,
Nick Senzel,187,224,262,299,374,468,748,1122,
Richard Lovelady,187,224,262,299,374,468,748,1122,
David Festa,186,223,260,298,372,465,744,1116,
Jake Bird,186,223,260,298,372,465,744,1116,
Wilmer Flores,185,222,259,296,370,463,740,1110,
Sam Hilliard,184,221,258,294,368,460,736,1104,
Steven Okert,183,220,256,293,366,458,732,1098,
Anthony Molina,182,218,255,291,364,455,728,1092,
Triston McKenzie,181,217,253,290,362,453,724,1086,
Addison Barger,180,216,252,288,360,450,720,1080,
Ronald Acuna Jr.,180,216,252,288,360,450,720,1080,
Shawn Dubin,180,216,252,288,360,450,720,1080,
Elehuris Montero,179,215,251,286,358,448,716,1074,
Kyle Leahy,178,214,249,285,356,445,712,1068,
Luke Little,178,214,249,285,356,445,712,1068,
Chris Roycroft,176,211,246,282,352,440,704,1056,
Jorge Mateo,176,211,246,282,352,440,704,1056,
Tony Santillan,175,210,245,280,350,438,700,1050,
Daniel Schneemann,174,209,244,278,348,435,696,1044,
Spencer Bivens,173,208,242,277,346,433,692,1038,
Dakota Hudson,172,206,241,275,344,430,688,1032,
Taylor Walls,170,204,238,272,340,425,680,1020,
Brandon Drury,168,202,235,269,336,420,672,1008,
Steven Wilson,168,202,235,269,336,420,672,1008,
Peter Lambert,166,199,232,266,332,415,664,996,
Michael Kelly,165,198,231,264,330,413,660,990,
Gabe Speier,164,197,230,262,328,410,656,984,
Robbie Grossman,164,197,230,262,328,410,656,984,
Yency Almonte,164,197,230,262,328,410,656,984,
Chad Kuhl,163,196,228,261,326,408,652,978,
Derek Hill,163,196,228,261,326,408,652,978,
Austin Slater,163,196,228,261,326,408,652,978,
Daysbel Hernandez,163,196,228,261,326,408,652,978,
Kyle Bradish,162,194,227,259,324,405,648,972,
DJ LeMahieu,161,193,225,258,322,403,644,966,
Junior Caminero,161,193,225,258,322,403,644,966,
Valente Bellozo,161,193,225,258,322,403,644,966,
Jackson Holliday,160,192,224,256,320,400,640,960,
Cavan Biggio,159,191,223,254,318,398,636,954,
Leo Jimenez,159,191,223,254,318,398,636,954,
Graham Ashcraft,158,190,221,253,316,395,632,948,
Ben Rice,157,188,220,251,314,393,628,942,
Jordan Leasure,157,188,220,251,314,393,628,942,
Anthony Rendon,154,185,216,246,308,385,616,924,
Carlos Hernandez,153,184,214,245,306,383,612,918,
Dillon Tate,153,184,214,245,306,383,612,918,
Jack Kochanowicz,153,184,214,245,306,383,612,918,
Slade Cecconi,153,184,214,245,306,383,612,918,
Alex Kirilloff,152,182,213,243,304,380,608,912,
Angel Chivilli,152,182,213,243,304,380,608,912,
Keegan Thompson,151,181,211,242,302,378,604,906,
Patrick Wisdom,151,181,211,242,302,378,604,906,
Kyle Stowers,150,180,210,240,300,375,600,900,
Noelvi Marte,150,180,210,240,300,375,600,900,
Jonathan Hernandez,149,179,209,238,298,373,596,894,
Daniel Lynch IV,148,178,207,237,296,370,592,888,
Edward Olivares,148,178,207,237,296,370,592,888,
Sean Guenther,148,178,207,237,296,370,592,888,
Christian Bethancourt,147,176,206,235,294,368,588,882,
Ryan Burr,147,176,206,235,294,368,588,882,
Brooks Lee,146,175,204,234,292,365,584,876,
Josh Jung,145,174,203,232,290,363,580,870,
Kody Funderburk,145,174,203,232,290,363,580,870,
Matt Bowman,145,174,203,232,290,363,580,870,
Dairon Blanco,145,174,203,232,290,363,580,870,
Alex Lange,144,173,202,230,288,360,576,864,
Adam Cimber,143,172,200,229,286,358,572,858,
Evan Carter,143,172,200,229,286,358,572,858,
Blaze Alexander,142,170,199,227,284,355,568,852,
Jordan Walker,142,170,199,227,284,355,568,852,
Keaton Winn,142,170,199,227,284,355,568,852,
Brenan Hanifee,142,170,199,227,284,355,568,852,
Kyle Muller,141,169,197,226,282,353,564,846,
Jhony Brito,140,168,196,224,280,350,560,840,
Roddery Munoz,140,168,196,224,280,350,560,840,
Thyago Vieira,140,168,196,224,280,350,560,840,
Dominic Canzone,139,167,195,222,278,348,556,834,
Kody Clemens,139,167,195,222,278,348,556,834,
Nick Martini,138,166,193,221,276,345,552,828,
Brent Honeywell,138,166,193,221,276,345,552,828,
Fraser Ellard,137,164,192,219,274,343,548,822,
Grant Anderson,137,164,192,219,274,343,548,822,
Jonathan Aranda,137,164,192,219,274,343,548,822,
Adrian Houser,136,163,190,218,272,340,544,816,
Brock Burke,136,163,190,218,272,340,544,816,
DJ Stewart,136,163,190,218,272,340,544,816,
Miguel Vargas,136,163,190,218,272,340,544,816,
Eduardo Salazar,135,162,189,216,270,338,540,810,
Nick Ahmed,135,162,189,216,270,338,540,810,
Dominic Fletcher,134,161,188,214,268,335,536,804,
Joe Boyle,133,160,186,213,266,333,532,798,
Angel Martinez,131,157,183,210,262,328,524,786,
Sean Reid-Foley,131,157,183,210,262,328,524,786,
Alex Call,130,156,182,208,260,325,520,780,
Dany Jimenez,130,156,182,208,260,325,520,780,
Drew Rasmussen,130,156,182,208,260,325,520,780,
Giovanny Gallegos,130,156,182,208,260,325,520,780,
Trey Sweeney,130,156,182,208,260,325,520,780,
Gus Varland,129,155,181,206,258,323,516,774,
Joey Cantillo,129,155,181,206,258,323,516,774,
Erik Sabrowski,129,155,181,206,258,323,516,774,
Matt Thaiss,127,152,178,203,254,318,508,762,
Bryan King,127,152,178,203,254,318,508,762,
Davis Martin,126,151,176,202,252,315,504,756,
Garrett Stubbs,126,151,176,202,252,315,504,756,
Matt Carpenter,126,151,176,202,252,315,504,756,
Taijuan Walker,126,151,176,202,252,315,504,756,
Xzavion Curry,126,151,176,202,252,315,504,756,
Drew Thorpe,125,150,175,200,250,313,500,750,
Josh Staumont,125,150,175,200,250,313,500,750,
Mike Trout,125,150,175,200,250,313,500,750,
Victor Gonzalez,125,150,175,200,250,313,500,750,
Daz Cameron,124,149,174,198,248,310,496,744,
Eduard Bazardo,124,149,174,198,248,310,496,744,
Emerson Hancock,124,149,174,198,248,310,496,744,
Luis Matos,124,149,174,198,248,310,496,744,
Corey Julks,123,148,172,197,246,308,492,738,
Dane Myers,123,148,172,197,246,308,492,738,
Jerar Encarnacion,123,148,172,197,246,308,492,738,
Gabriel Arias,122,146,171,195,244,305,488,732,
Quinn Priester,122,146,171,195,244,305,488,732,
Austin Barnes,121,145,169,194,242,303,484,726,
Brett Baty,121,145,169,194,242,303,484,726,
Cristian Pache,121,145,169,194,242,303,484,726,
Eduardo Rodriguez,121,145,169,194,242,303,484,726,
Jose Tena,121,145,169,194,242,303,484,726,
Kyle McCann,121,145,169,194,242,303,484,726,
Sam Hentges,121,145,169,194,242,303,484,726,
Travis Jankowski,120,144,168,192,240,300,480,720,
Ty Blach,120,144,168,192,240,300,480,720,
Bryce Elder,119,143,167,190,238,298,476,714,
Tim Anderson,119,143,167,190,238,298,476,714,
Cristian Javier,118,142,165,189,236,295,472,708,
Josh Fleming,118,142,165,189,236,295,472,708,
Max Scherzer,118,142,165,189,236,295,472,708,
Seth Halvorsen,118,142,165,189,236,295,472,708,
Christian Scott,116,139,162,186,232,290,464,696,
Jordan Wicks,116,139,162,186,232,290,464,696,
Reese McGuire,116,139,162,186,232,290,464,696,
Andruw Monasterio,114,137,160,182,228,285,456,684,
Andres Chaparro,114,137,160,182,228,285,456,684,
Casey Schmitt,114,137,160,182,228,285,456,684,
Grant Holman,114,137,160,182,228,285,456,684,
Adrian Del Castillo,113,136,158,181,226,283,452,678,
Drew Smith,113,136,158,181,226,283,452,678,
Luis Urias,113,136,158,181,226,283,452,678,
George Soriano,112,134,157,179,224,280,448,672,
Hans Crouse,112,134,157,179,224,280,448,672,
Trey Lipscomb,112,134,157,179,224,280,448,672,
Luis Guillorme,110,132,154,176,220,275,440,660,
Robbie Ray,110,132,154,176,220,275,440,660,
Troy Taylor,110,132,154,176,220,275,440,660,
Aaron Ashby,109,131,153,174,218,273,436,654,
Luis Torrens,108,130,151,173,216,270,432,648,
Ethan Roberts,107,128,150,171,214,268,428,642,
Jordan Beck,107,128,150,171,214,268,428,642,
DL Hall,105,126,147,168,210,263,420,630,
Jose Quijada,105,126,147,168,210,263,420,630,
Kris Bryant,105,126,147,168,210,263,420,630,
Scott McGough,105,126,147,168,210,263,420,630,
Grant McCray,104,125,146,166,208,260,416,624,
Brock Stewart,103,124,144,165,206,258,412,618,
Josh Sborz,103,124,144,165,206,258,412,618,
Nick Loftin,103,124,144,165,206,258,412,618,
Austin Hedges,103,124,144,165,206,258,412,618,
Hunter Bigge,102,122,143,163,204,255,408,612,
Kaleb Ort,102,122,143,163,204,255,408,612,
Adbert Alzolay,101,121,141,162,202,253,404,606,
Ron Marinaccio,101,121,141,162,202,253,404,606,
Tyler Wade,100,120,140,160,200,250,400,600,
Braxton Garrett,99,119,139,158,198,248,396,594,
Jeffrey Springs,99,119,139,158,198,248,396,594,
J.D. Davis,98,118,137,157,196,245,392,588,
Jordan Romano,98,118,137,157,196,245,392,588,
Jung Hoo Lee,98,118,137,157,196,245,392,588,
Logan Allen,98,118,137,157,196,245,392,588,
J.T. Ginn,96,115,134,154,192,240,384,576,
Jay Jackson,96,115,134,154,192,240,384,576,
Tomas Nido,96,115,134,154,192,240,384,576,
Trevor Story,96,115,134,154,192,240,384,576,
Tyler Phillips,95,114,133,152,190,238,380,570,
Heston Kjerstad,94,113,132,150,188,235,376,564,
Prelander Berroa,94,113,132,150,188,235,376,564,
Victor Scott II,94,113,132,150,188,235,376,564,
Weston Wilson,94,113,132,150,188,235,376,564,
Abner Uribe,93,112,130,149,186,233,372,558,
Brad Keller,93,112,130,149,186,233,372,558,
Griffin Conine,93,112,130,149,186,233,372,558,
Rhett Lowder,93,112,130,149,186,233,372,558,
Robert Gasser,93,112,130,149,186,233,372,558,
Alex Jackson,92,110,129,147,184,230,368,552,
Bobby Miller,92,110,129,147,184,230,368,552,
Ryder Ryan,92,110,129,147,184,230,368,552,
Anthony Maldonado,91,109,127,146,182,228,364,546,
Enoli Paredes,91,109,127,146,182,228,364,546,
Tom Cosgrove,91,109,127,146,182,228,364,546,
Danny Mendick,90,108,126,144,180,225,360,540,
Dominic Leone,90,108,126,144,180,225,360,540,
James Outman,90,108,126,144,180,225,360,540,
Yuli Gurriel,90,108,126,144,180,225,360,540,
Bryan Ramos,89,107,125,142,178,223,356,534,
Darren McCaughan,89,107,125,142,178,223,356,534,
Estevan Florial,89,107,125,142,178,223,356,534,
Max Meyer,89,107,125,142,178,223,356,534,
Yunior Marte,89,107,125,142,178,223,356,534,
Christian Encarnacion-Strand,88,106,123,141,176,220,352,528,
Sean Bouchard,88,106,123,141,176,220,352,528,
Alek Thomas,87,104,122,139,174,218,348,522,
Darell Hernaiz,87,104,122,139,174,218,348,522,
Dylan Crews,87,104,122,139,174,218,348,522,
Louie Varland,87,104,122,139,174,218,348,522,
Michael McGreevy,87,104,122,139,174,218,348,522,
Steven Matz,87,104,122,139,174,218,348,522,
Andrew Walters,87,104,122,139,174,218,348,522,
Alek Manoah,86,103,120,138,172,215,344,516,
Bryan Baker,86,103,120,138,172,215,344,516,
Chris Devenski,86,103,120,138,172,215,344,516,
Aaron Schunk,85,102,119,136,170,213,340,510,
Ronny Henriquez,85,102,119,136,170,213,340,510,
Adam Oller,84,101,118,134,168,210,336,504,
Clayton Kershaw,84,101,118,134,168,210,336,504,
Jose Cisnero,84,101,118,134,168,210,336,504,
Luis Medina,84,101,118,134,168,210,336,504,
Ben Casparius,84,101,118,134,168,210,336,504,
Brooks Baldwin,83,100,116,133,166,208,332,498,
Eric Haase,83,100,116,133,166,208,332,498,
Jose Herrera,83,100,116,133,166,208,332,498,
Curtis Mead,82,98,115,131,164,205,328,492,
Justin Wrobleski,82,98,115,131,164,205,328,492,
Nathan Lukes,82,98,115,131,164,205,328,492,
Rece Hinds,82,98,115,131,164,205,328,492,
Zebby Matthews,82,98,115,131,164,205,328,492,
Luke Maile,81,97,113,130,162,203,324,486,
Riley Adams,81,97,113,130,162,203,324,486,
Alex Young,80,96,112,128,160,200,320,480,
Erasmo Ramirez,80,96,112,128,160,200,320,480,
Ryan Zeferjahn,80,96,112,128,160,200,320,480,
Will Wagner,80,96,112,128,160,200,320,480,
Sixto Sanchez,79,95,111,126,158,198,316,474,
Curt Casali,77,92,108,123,154,193,308,462,
Emmanuel Ramirez,77,92,108,123,154,193,308,462,
Nick Burdi,77,92,108,123,154,193,308,462,
Joshua Palacios,76,91,106,122,152,190,304,456,
Niko Kavadas,76,91,106,122,152,190,304,456,
Tommy Nance,76,91,106,122,152,190,304,456,
Brandon Bielak,75,90,105,120,150,188,300,450,
Sean Reynolds,75,90,105,120,150,188,300,450,
Ben Gamel,74,89,104,118,148,185,296,444,
Jeff Criswell,74,89,104,118,148,185,296,444,
Marco Gonzales,74,89,104,118,148,185,296,444,
Martin Maldonado,74,89,104,118,148,185,296,444,
Michael Stefanic,74,89,104,118,148,185,296,444,
Nick Vespi,74,89,104,118,148,185,296,444,
Shane Bieber,74,89,104,118,148,185,296,444,
Yilber Diaz,74,89,104,118,148,185,296,444,
Brett Harris,73,88,102,117,146,183,292,438,
Garrett Cooper,73,88,102,117,146,183,292,438,
Julian Aguiar,73,88,102,117,146,183,292,438,
Ryan Bliss,73,88,102,117,146,183,292,438,
Alex Cobb,73,88,102,117,146,183,292,438,
Brady Basso,72,86,101,115,144,180,288,432,
Bryan Sammons,72,86,101,115,144,180,288,432,
Colten Brewer,72,86,101,115,144,180,288,432,
Gerson Garabito,72,86,101,115,144,180,288,432,
River Ryan,72,86,101,115,144,180,288,432,
Jacob Wilson,71,85,99,114,142,178,284,426,
Sean Burke,71,85,99,114,142,178,284,426,
Jon Berti,71,85,99,114,142,178,284,426,
Alek Jacob,71,85,99,114,142,178,284,426,
Daniel Palencia,70,84,98,112,140,175,280,420,
Joe La Sorsa,70,84,98,112,140,175,280,420,
Jace Jung,70,84,98,112,140,175,280,420,
Mason Montgomery,69,83,97,110,138,173,276,414,
Ryan Miller,69,83,97,110,138,173,276,414,
Trey Cabbage,69,83,97,110,138,173,276,414,
Brooks Raley,68,82,95,109,136,170,272,408,
Cody Poteet,68,82,95,109,136,170,272,408,
Davis Daniel,68,82,95,109,136,170,272,408,
John McMillon,68,82,95,109,136,170,272,408,
John Means,68,82,95,109,136,170,272,408,
Nick Nastrini,68,82,95,109,136,170,272,408,
Mason Black,66,79,92,106,132,165,264,396,
Matt Manning,66,79,92,106,132,165,264,396,
Deivi Garcia,65,78,91,104,130,163,260,390,
Alex Wood,64,77,90,102,128,160,256,384,
Dillon Dingler,64,77,90,102,128,160,256,384,
Eric Wagaman,64,77,90,102,128,160,256,384,
Guillo Zuniga,64,77,90,102,128,160,256,384,
Jose Marte,64,77,90,102,128,160,256,384,
Michael Petersen,64,77,90,102,128,160,256,384,
Tyler Beede,64,77,90,102,128,160,256,384,
Yerry Rodriguez,64,77,90,102,128,160,256,384,
Daniel Vogelbach,63,76,88,101,126,158,252,378,
Jose Cuas,63,76,88,101,126,158,252,378,
Nick Sogard,63,76,88,101,126,158,252,378,
Jake Woodford,62,74,87,99,124,155,248,372,
Julian Merryweather,62,74,87,99,124,155,248,372,
Matt Festa,62,74,87,99,124,155,248,372,
Scott Blewett,62,74,87,99,124,155,248,372,
Spencer Howard,62,74,87,99,124,155,248,372,
Tanner Gordon,62,74,87,99,124,155,248,372,
Brandon Hughes,61,73,85,98,122,153,244,366,
Cole Sulser,61,73,85,98,122,153,244,366,
Lake Bachar,61,73,85,98,122,153,244,366,
Mason Englert,61,73,85,98,122,153,244,366,
Miguel Sano,61,73,85,98,122,153,244,366,
Vaughn Grissom,60,72,84,96,120,150,240,360,
Brusdar Graterol,60,72,84,96,120,150,240,360,
Kyle Nelson,59,71,83,94,118,148,236,354,
Leo Rivas,59,71,83,94,118,148,236,354,
Rafael Marchon,59,71,83,94,118,148,236,354,
Garrett Whitlock,58,70,81,93,116,145,232,348,
Luis Peralta,58,70,81,93,116,145,232,348,
Matt Sauer,58,70,81,93,116,145,232,348,
Cody Bolton,57,68,80,91,114,143,228,342,
Jack Leiter,57,68,80,91,114,143,228,342,
Oliver Dunn,57,68,80,91,114,143,228,342,
Richard Fitts,57,68,80,91,114,143,228,342,
Jasson Dominguez,57,68,80,91,114,143,228,342,
Bligh Madris,56,67,78,90,112,140,224,336,
Kyle Tyler,56,67,78,90,112,140,224,336,
Tommy Henry,56,67,78,90,112,140,224,336,
Tucker Barnhart,56,67,78,90,112,140,224,336,
Zach DeLoach,56,67,78,90,112,140,224,336,
Eguy Rosario,55,66,77,88,110,138,220,330,
Jack Lopez,55,66,77,88,110,138,220,330,
Ryan Noda,55,66,77,88,110,138,220,330,
Vinny Nittoli,55,66,77,88,110,138,220,330,
Walter Pennington,55,66,77,88,110,138,220,330,
Yosver Zulueta,55,66,77,88,110,138,220,330,
Zack Short,55,66,77,88,110,138,220,330,
Jonatan Clase,54,65,76,86,108,135,216,324,
Kevin Herget,54,65,76,86,108,135,216,324,
Tyler Matzek,54,65,76,86,108,135,216,324,
Akil Baddoo,53,64,74,85,106,133,212,318,
Luis Guerrero,53,64,74,85,106,133,212,318,
Luken Baker,53,64,74,85,106,133,212,318,
Brett de Geus,52,62,73,83,104,130,208,312,
Esteury Ruiz,52,62,73,83,104,130,208,312,
Matt Barnes,52,62,73,83,104,130,208,312,
Nasim Nunez,52,62,73,83,104,130,208,312,
Zach Dezenzo,52,62,73,83,104,130,208,312,
Henry Davis,51,61,71,82,102,128,204,306,
Miles Mastrobuoni,51,61,71,82,102,128,204,306,
Touki Toussaint,51,61,71,82,102,128,204,306,
Alika Williams,50,60,70,80,100,125,200,300,
Andrew Knizner,50,60,70,80,100,125,200,300,
David Dahl,50,60,70,80,100,125,200,300,
Luisangel Acuna,50,60,70,80,100,125,200,300,
Ray Kerr,50,60,70,80,100,125,200,300,
Edgardo Henriquez,50,60,70,80,100,125,200,300,
Aaron Brooks,49,59,69,78,98,123,196,294,
Cole Winn,49,59,69,78,98,123,196,294,
Domingo German,49,59,69,78,98,123,196,294,
Joely Rodriguez,49,59,69,78,98,123,196,294,
Jose Azocar,49,59,69,78,98,123,196,294,
Jose Fermin,49,59,69,78,98,123,196,294,
Kent Emanuel,49,59,69,78,98,123,196,294,
Nick Madrigal,49,59,69,78,98,123,196,294,
Tristan Beck,49,59,69,78,98,123,196,294,
Billy Cook,48,58,67,77,96,120,192,288,
Bryce Johnson,48,58,67,77,96,120,192,288,
Jose Abreu,48,58,67,77,96,120,192,288,
Nick Allen,48,58,67,77,96,120,192,288,
Jaden Hill,47,56,66,75,94,118,188,282,
Kenny Rosenberg,47,56,66,75,94,118,188,282,
Kolby Allard,47,56,66,75,94,118,188,282,
Marco Luciano,47,56,66,75,94,118,188,282,
Ty Madden,47,56,66,75,94,118,188,282,
Anthony Veneziano,46,55,64,74,92,115,184,276,
Bailey Horn,46,55,64,74,92,115,184,276,
Elieser Hernandez,46,55,64,74,92,115,184,276,
Kirby Snead,46,55,64,74,92,115,184,276,
Bobby Dalbec,45,54,63,72,90,113,180,270,
Brandon Crawford,45,54,63,72,90,113,180,270,
David Bote,44,53,62,70,88,110,176,264,
Rob Zastryzny,44,53,62,70,88,110,176,264,
David Hensley,43,52,60,69,86,108,172,258,
Humberto Castellanos,43,52,60,69,86,108,172,258,
J.P. Feyereisen,43,52,60,69,86,108,172,258,
Sammy Peralta,43,52,60,69,86,108,172,258,
J.B. Bukauskas,42,50,59,67,84,105,168,252,
Jamie Westbrook,42,50,59,67,84,105,168,252,
Jared Walsh,42,50,59,67,84,105,168,252,
Logan Gillaspie,42,50,59,67,84,105,168,252,
Luke Williams,42,50,59,67,84,105,168,252,
Ryan Borucki,42,50,59,67,84,105,168,252,
Ali Sanchez,41,49,57,66,82,103,164,246,
Gustavo Campero,41,49,57,66,82,103,164,246,
Rene Pinto,41,49,57,66,82,103,164,246,
Yan Gomes,41,49,57,66,82,103,164,246,
Josh Walker,40,48,56,64,80,100,160,240,
Mitch White,40,48,56,64,80,100,160,240,
Shay Whitcomb,40,48,56,64,80,100,160,240,
Adam Mazur,39,47,55,62,78,98,156,234,
Blake Walston,39,47,55,62,78,98,156,234,
Ji Hwan Bae,39,47,55,62,78,98,156,234,
Peter Strzelecki,39,47,55,62,78,98,156,234,
Kodai Senga,39,47,55,62,78,98,156,234,
Mason McCoy,38,46,53,61,76,95,152,228,
Yonny Chirinos,38,46,53,61,76,95,152,228,
Ben Heller,37,44,52,59,74,93,148,222,
Bradley Blalock,37,44,52,59,74,93,148,222,
Brandon Williamson,37,44,52,59,74,93,148,222,
Cal Stevenson,37,44,52,59,74,93,148,222,
Drew Millas,37,44,52,59,74,93,148,222,
Jahmai Jones,37,44,52,59,74,93,148,222,
Nick Yorke,37,44,52,59,74,93,148,222,
Ryan Kreidler,37,44,52,59,74,93,148,222,
Austin Warren,36,43,50,58,72,90,144,216,
Chadwick Tromp,36,43,50,58,72,90,144,216,
Isaiah Campbell,36,43,50,58,72,90,144,216,
Miguel Castro,36,43,50,58,72,90,144,216,
Nick Robertson,36,43,50,58,72,90,144,216,
Eli White,35,42,49,56,70,88,140,210,
J.P. France,35,42,49,56,70,88,140,210,
Jairo Iriarte,35,42,49,56,70,88,140,210,
Brian Serven,34,41,48,54,68,85,136,204,
Cole Tucker,34,41,48,54,68,85,136,204,
Gregory Santos,34,41,48,54,68,85,136,204,
Jacob deGrom,34,41,48,54,68,85,136,204,
Sam Aldegheri,34,41,48,54,68,85,136,204,
Tyler Gilbert,34,41,48,54,68,85,136,204,
Austin Shenton,33,40,46,53,66,83,132,198,
David Villar,33,40,46,53,66,83,132,198,
Jacob Hurtubise,33,40,46,53,66,83,132,198,
Noah Davis,33,40,46,53,66,83,132,198,
Jimmy Herget,32,38,45,51,64,80,128,192,
Kyren Paris,32,38,45,51,64,80,128,192,
Luis Frias,32,38,45,51,64,80,128,192,
Yoendrys Gomez,32,38,45,51,64,80,128,192,
Cesar Salazar,31,37,43,50,62,78,124,186,
Drew Romo,31,37,43,50,62,78,124,186,
Jacob Amaya,31,37,43,50,62,78,124,186,
Jose E. Hernandez,31,37,43,50,62,78,124,186,
Josh Winder,31,37,43,50,62,78,124,186,
Kumar Rocker,31,37,43,50,62,78,124,186,
Pablo Reyes,31,37,43,50,62,78,124,186,
Parker Mushinski,31,37,43,50,62,78,124,186,
Phil Bickford,31,37,43,50,62,78,124,186,
Steven Cruz,31,37,43,50,62,78,124,186,
Tyler Wells,31,37,43,50,62,78,124,186,
Chase Shugart,30,36,42,48,60,75,120,180,
Jordyn Adams,30,36,42,48,60,75,120,180,
Omar Narvaez,30,36,42,48,60,75,120,180,
Tyler Locklear,30,36,42,48,60,75,120,180,
Tyler Mahle,30,36,42,48,60,75,120,180,
Avisail Garcia,29,35,41,46,58,73,116,174,
Janson Junk,29,35,41,46,58,73,116,174,
Ky Bush,29,35,41,46,58,73,116,174,
Max Lazar,29,35,41,46,58,73,116,174,
Tyler Black,29,35,41,46,58,73,116,174,
Zach Remillard,29,35,41,46,58,73,116,174,
Zack Thompson,29,35,41,46,58,73,116,174,
Buddy Kennedy,28,34,39,45,56,70,112,168,
Charles Leblanc,28,34,39,45,56,70,112,168,
Steward Berroa,28,34,39,45,56,70,112,168,
Thomas Saggese,28,34,39,45,56,70,112,168,
Aaron Hicks,27,32,38,43,54,68,108,162,
Luis Contreras,27,32,38,43,54,68,108,162,
Ryan Vilade,27,32,38,43,54,68,108,162,
Tyler Duffey,27,32,38,43,54,68,108,162,
Yoen Moncada,27,32,38,43,54,68,108,162,
Amir Garrett,26,31,36,42,52,65,104,156,
Braden Shewmake,26,31,36,42,52,65,104,156,
Jacob Lopez,26,31,36,42,52,65,104,156,
Jordan Lyles,25,30,35,40,50,63,100,150,
Logan Driscoll,25,30,35,40,50,63,100,150,
Oscar Colas,25,30,35,40,50,63,100,150,
Connor Gillispie,24,29,34,38,48,60,96,144,
Dinelson Lamet,24,29,34,38,48,60,96,144,
Jackson Rutledge,24,29,34,38,48,60,96,144,
Johnathan Rodriguez,24,29,34,38,48,60,96,144,
Jonathan Ornelas,24,29,34,38,48,60,96,144,
Ricardo Pinto,24,29,34,38,48,60,96,144,
Alexander Canario,23,28,32,37,46,58,92,138,
Blake Sabol,23,28,32,37,46,58,92,138,
Chuckie Robinson,23,28,32,37,46,58,92,138,
Jason Delay,23,28,32,37,46,58,92,138,
Matt Carasiti,23,28,32,37,46,58,92,138,
Michael Mercado,23,28,32,37,46,58,92,138,
Mike Clevinger,23,28,32,37,46,58,92,138,
Mike Ford,23,28,32,37,46,58,92,138,
Will Klein,23,28,32,37,46,58,92,138,
Alan Trejo,22,26,31,35,44,55,88,132,
Caleb Kilian,22,26,31,35,44,55,88,132,
Casey Kelly,22,26,31,35,44,55,88,132,
Colin Selby,22,26,31,35,44,55,88,132,
Diego Castillo,22,26,31,35,44,55,88,132,
Graham Pauley,22,26,31,35,44,55,88,132,
Joel Kuhnel,22,26,31,35,44,55,88,132,
Nabil Crismatt,22,26,31,35,44,55,88,132,
Nick Ramirez,22,26,31,35,44,55,88,132,
Armando Alvarez,21,25,29,34,42,53,84,126,
Jack Neely,21,25,29,34,42,53,84,126,
Nick Hernandez,21,25,29,34,42,53,84,126,
Riley O'Brien,21,25,29,34,42,53,84,126,
Spencer Strider,21,25,29,34,42,53,84,126,
Trey Wingenter,21,25,29,34,42,53,84,126,
Blake Dunn,20,24,28,32,40,50,80,120,
Daulton Jefferies,20,24,28,32,40,50,80,120,
Easton Lucas,20,24,28,32,40,50,80,120,
Forrest Wall,20,24,28,32,40,50,80,120,
Jhonny Pereda,20,24,28,32,40,50,80,120,
Joan Adon,20,24,28,32,40,50,80,120,
Joey Lucchesi,20,24,28,32,40,50,80,120,
Josh Maciejewski,20,24,28,32,40,50,80,120,
Seby Zavala,20,24,28,32,40,50,80,120,
Tom Murphy,20,24,28,32,40,50,80,120,
Billy McKinney,19,23,27,30,38,48,76,114,
Matt Foster,19,23,27,30,38,48,76,114,
Austin Davis,18,22,25,29,36,45,72,108,
Austin Wynns,18,22,25,29,36,45,72,108,
Chase Silseth,18,22,25,29,36,45,72,108,
Davis Wendzel,18,22,25,29,36,45,72,108,
Isaac Mattson,18,22,25,29,36,45,72,108,
Joey Wendle,18,22,25,29,36,45,72,108,
Kyle Hurt,18,22,25,29,36,45,72,108,
Stone Garrett,18,22,25,29,36,45,72,108,
Wes Parsons,18,22,25,29,36,45,72,108,
Will Warren,18,22,25,29,36,45,72,108,
AJ Smith-Shawver,17,20,24,27,34,43,68,102,
Dallas Keuchel,17,20,24,27,34,43,68,102,
Darius Vines,17,20,24,27,34,43,68,102,
Ehire Adrianza,17,20,24,27,34,43,68,102,
Jack O'Loughlin,17,20,24,27,34,43,68,102,
Jackson Jobe,17,20,24,27,34,43,68,102,
Jhonathan Diaz,17,20,24,27,34,43,68,102,
Randy Dobnak,17,20,24,27,34,43,68,102,
Ricky Vanasco,17,20,24,27,34,43,68,102,
Ryan McKenna,17,20,24,27,34,43,68,102,
Sean Newcomb,17,20,24,27,34,43,68,102,
Travis Blankenhorn,17,20,24,27,34,43,68,102,
Gordon Graceffo,16,19,22,26,32,40,64,96,
Javier Sanoja,16,19,22,26,32,40,64,96,
Nick Avila,16,19,22,26,32,40,64,96,
Shaun Anderson,16,19,22,26,32,40,64,96,
Brandon Lockridge,15,18,21,24,30,38,60,90,
Caden Dana,15,18,21,24,30,38,60,90,
Jason Vosler,15,18,21,24,30,38,60,90,
Josh Rogers,15,18,21,24,30,38,60,90,
Owen Miller,15,18,21,24,30,38,60,90,
Tyler Jay,15,18,21,24,30,38,60,90,
Zach Penrod,15,18,21,24,30,38,60,90,
Adael Amador,14,17,20,22,28,35,56,84,
Drew Waters,14,17,20,22,28,35,56,84,
Dustin Harris,14,17,20,22,28,35,56,84,
Jake Bloss,14,17,20,22,28,35,56,84,
Matt Andriese,14,17,20,22,28,35,56,84,
Nick Nelson,14,17,20,22,28,35,56,84,
Donovan Walton,13,16,18,21,26,33,52,78,
Tucker Davidson,13,16,18,21,26,33,52,78,
Jacob Waguespack,12,14,17,19,24,30,48,72,
Naoyuki Uwasawa,12,14,17,19,24,30,48,72,
Rich Hill,12,14,17,19,24,30,48,72,
Trenton Brooks,12,14,17,19,24,30,48,72,
Zach Plesac,12,14,17,19,24,30,48,72,
Carlos Rodriguez,11,13,15,18,22,28,44,66,
Casey Legumina,11,13,15,18,22,28,44,66,
Dan Altavilla,11,13,15,18,22,28,44,66,
Daniel Robert,11,13,15,18,22,28,44,66,
Darren Baker,11,13,15,18,22,28,44,66,
Diego A. Castillo,11,13,15,18,22,28,44,66,
Jakson Reetz,11,13,15,18,22,28,44,66,
Jonathan Loaisiga,11,13,15,18,22,28,44,66,
Justin Bruihl,11,13,15,18,22,28,44,66,
Kai-Wei Teng,11,13,15,18,22,28,44,66,
Luis De Los Santos,11,13,15,18,22,28,44,66,
Matt Mervis,11,13,15,18,22,28,44,66,
Rafael Ortega,11,13,15,18,22,28,44,66,
Trevor McDonald,11,13,15,18,22,28,44,66,
Brandon Eisert,10,12,14,16,20,25,40,60,
Brett Sullivan,10,12,14,16,20,25,40,60,
Clayton Beeter,10,12,14,16,20,25,40,60,
Daniel Duarte,10,12,14,16,20,25,40,60,
Hunter Feduccia,10,12,14,16,20,25,40,60,
Justin Sterner,10,12,14,16,20,25,40,60,
Justin Topa,10,12,14,16,20,25,40,60,
Ty Adcock,10,12,14,16,20,25,40,60,
Wade Miley,10,12,14,16,20,25,40,60,
Zach Brzykcy,10,12,14,16,20,25,40,60,
Coby Mayo,9,11,13,14,18,23,36,54,
Eli Villalobos,9,11,13,14,18,23,36,54,
Forrest Whitley,9,11,13,14,18,23,36,54,
Jonathan Heasley,9,11,13,14,18,23,36,54,
Jorge Barrosa,9,11,13,14,18,23,36,54,
Oswald Peraza,9,11,13,14,18,23,36,54,
Scott Effross,9,11,13,14,18,23,36,54,
Aledmys Diaz,8,10,11,13,16,20,32,48,
Antonio Senzatela,8,10,11,13,16,20,32,48,
Brent Headrick,8,10,11,13,16,20,32,48,
Geoff Hartlieb,8,10,11,13,16,20,32,48,
Joey Wiemer,8,10,11,13,16,20,32,48,
Liover Peguero,8,10,11,13,16,20,32,48,
Matt Koch,8,10,11,13,16,20,32,48,
Tyler Heineman,8,10,11,13,16,20,32,48,
Vladimir Gutierrez,8,10,11,13,16,20,32,48,
DaShawn Keirsey Jr.,7,8,10,11,14,18,28,42,
Greg Jones,7,8,10,11,14,18,28,42,
Jackson Stephens,7,8,10,11,14,18,28,42,
Keston Hiura,7,8,10,11,14,18,28,42,
Livan Soto,7,8,10,11,14,18,28,42,
Michael Helman,7,8,10,11,14,18,28,42,
Niko Goodrum,7,8,10,11,14,18,28,42,
Pedro Leon,7,8,10,11,14,18,28,42,
Tyler Zuber,7,8,10,11,14,18,28,42,
Adam Kloffenstein,6,7,8,10,12,15,24,36,
David Buchanan,6,7,8,10,12,15,24,36,
David Fletcher,6,7,8,10,12,15,24,36,
Johnny Cueto,6,7,8,10,12,15,24,36,
Luis Vazquez,6,7,8,10,12,15,24,36,
Mickey Gasper,6,7,8,10,12,15,24,36,
Tejay Antone,6,7,8,10,12,15,24,36,
Zach Logue,6,7,8,10,12,15,24,36,
Austin Kitchen,5,6,7,8,10,13,20,30,
Brandon Leibrandt,5,6,7,8,10,13,20,30,
Bryan Shaw,5,6,7,8,10,13,20,30,
Bubba Thompson,5,6,7,8,10,13,20,30,
Carlos Narvaez,5,6,7,8,10,13,20,30,
Chayce McDermott,5,6,7,8,10,13,20,30,
Duke Ellis,5,6,7,8,10,13,20,30,
Grant Hartwig,5,6,7,8,10,13,20,30,
Isaac Collins,5,6,7,8,10,13,20,30,
Justin Foscue,5,6,7,8,10,13,20,30,
Mike Burrows,5,6,7,8,10,13,20,30,
Riley Pint,5,6,7,8,10,13,20,30,
Tristan Gray,5,6,7,8,10,13,20,30,
Alan Busenitz,4,5,6,6,8,10,16,24,
Conner Capel,4,5,6,6,8,10,16,24,
Dylan Coleman,4,5,6,6,8,10,16,24,
Gerardo Reyes,4,5,6,6,8,10,16,24,
J.P. Martinez,4,5,6,6,8,10,16,24,
Jace Peterson,4,5,6,6,8,10,16,24,
Levi Jordan,4,5,6,6,8,10,16,24,
Matthew Batten,4,5,6,6,8,10,16,24,
Paolo Espino,4,5,6,6,8,10,16,24,
Ryan Loutos,4,5,6,6,8,10,16,24,
Sam Haggerty,4,5,6,6,8,10,16,24,
Cade Marlowe,3,4,4,5,6,8,12,18,
Caleb Boushley,3,4,4,5,6,8,12,18,
Gavin Hollowell,3,4,4,5,6,8,12,18,
Jake Eder,3,4,4,5,6,8,12,18,
Joe Jacques,3,4,4,5,6,8,12,18,
Marc Church,3,4,4,5,6,8,12,18,
Miguel Diaz,3,4,4,5,6,8,12,18,
Orlando Ribalta,3,4,4,5,6,8,12,18,
Samad Taylor,3,4,4,5,6,8,12,18,
Taylor Trammell,3,4,4,5,6,8,12,18,
Zac Kristofak,3,4,4,5,6,8,12,18,
Alex Speas,2,2,3,3,4,5,8,12,
Anthony Misiewicz,2,2,3,3,4,5,8,12,
Bryce Teodosio,2,2,3,3,4,5,8,12,
Chasen Shreve,2,2,3,3,4,5,8,12,
Eddy Alvarez,2,2,3,3,4,5,8,12,
Edwin Raos,2,2,3,3,4,5,8,12,
Evan Justice,2,2,3,3,4,5,8,12,
Evan Kravetz,2,2,3,3,4,5,8,12,
Grae Kessinger,2,2,3,3,4,5,8,12,
Matt Duffy,2,2,3,3,4,5,8,12,
Myles Straw,2,2,3,3,4,5,8,12,
Nacho Alvarez Jr.,2,2,3,3,4,5,8,12,
Nick Pratto,2,2,3,3,4,5,8,12,
Victor Mederos,2,2,3,3,4,5,8,12,
Vinny Capra,2,2,3,3,4,5,8,12,
Andrew Saalfrank,1,1,1,2,2,3,4,6,
CJ Alexander,1,1,1,2,2,3,4,6,
Ian Gibaut,1,1,1,2,2,3,4,6,
Jair Camargo,1,1,1,2,2,3,4,6,
James Meeker,1,1,1,2,2,3,4,6,
Jonathan Bermudez,1,1,1,2,2,3,4,6,
Jose Devers,1,1,1,2,2,3,4,6,
Kameron Misner,1,1,1,2,2,3,4,6,
Kevin Alcantara,1,1,1,2,2,3,4,6,
Lucas Gilbreath,1,1,1,2,2,3,4,6,
Orelvis Martinez,1,1,1,2,2,3,4,6,
Rob Brantly,1,1,1,2,2,3,4,6,
Tony Kemp,1,1,1,2,2,3,4,6,
Austin Pruitt,0,0,0,0,0,0,0,0,
Brewer Hicklen,0,0,0,0,0,0,0,0,
Cooper Hummel,0,0,0,0,0,0,0,0,
Daniel Johnson,0,0,0,0,0,0,0,0,
Grant Koch,0,0,0,0,0,0,0,0,
