player_name,Team,common_value,uncommon_value,rare_value,epic_value,leg_value,mystic_value,iconic_value
Shohei Ohtani,LAD,1608,1876,2144,2680,3350,5360,8040
Aaron Judge,NYY,1544,1802,2059,2574,3218,5148,7722
Juan Soto,NYY,1446,1687,1928,2410,3013,4820,7230
Francisco Lindor,NYM,1206,1407,1608,2010,2513,4020,6030
Jose Ramirez,CLE,1183,1380,1578,1972,2465,3944,5916
Freddie Freeman,LAD,1177,1373,1570,1962,2453,3924,5886
Emmanuel Clase,CLE,1170,1365,1560,1950,2438,3900,5850
Tarik Skubal,DET,1157,1350,1542,1928,2410,3856,5784
Teoscar Hernandez,LAD,1152,1344,1536,1920,2400,3840,5760
Pete Alonso,NYM,1142,1333,1523,1904,2380,3808,5712
Bobby Witt Jr.,KC,1140,1330,1520,1900,2375,3800,5700
Mookie Betts,LAD,1127,1315,1502,1878,2348,3756,5634
Mark Vientos,NYM,1026,1197,1368,1710,2138,3420,5130
Giancarlo Stanton,NYY,1021,1191,1362,1702,2128,3404,5106
Vladimir Guerrero Jr.,TOR,1008,1176,1344,1680,2100,3360,5040
Kyle Schwarber,PHI,997,1163,1330,1662,2078,3324,4986
Zack Wheeler,PHI,992,1158,1323,1654,2068,3308,4962
Jackson Merrill,SD,962,1123,1283,1604,2005,3208,4812
Manny Machado,SD,960,1120,1280,1600,2000,3200,4800
Josh Naylor,CLE,959,1119,1278,1598,1998,3196,4794
Ryan Helsley,STL,954,1113,1272,1590,1988,3180,4770
Gunnar Henderson,BAL,953,1112,1270,1588,1985,3176,4764
Marcell Ozuna,ATL,950,1109,1267,1584,1980,3168,4752
Bryce Harper,PHI,942,1099,1256,1570,1963,3140,4710
Anthony Volpe,NYY,922,1075,1229,1536,1920,3072,4608
Raisel Iglesias,ATL,920,1074,1227,1534,1918,3068,4602
Willy Adames,MIL,916,1068,1221,1526,1908,3052,4578
Sean Manaea,NYM,916,1068,1221,1526,1908,3052,4578
Cole Ragans,KC,914,1067,1219,1524,1905,3048,4572
Gleyber Torres,NYY,913,1065,1218,1522,1903,3044,4566
Yordan Alvarez,HOU,912,1064,1216,1520,1900,3040,4560
Clay Holmes,NYY,910,1061,1213,1516,1895,3032,4548
Jarren Duran,BOS,901,1051,1202,1502,1878,3004,4506
Brent Rooker,OAK,900,1050,1200,1500,1875,3000,4500
Brandon Nimmo,NYM,892,1040,1189,1486,1858,2972,4458
Nick Castellanos,PHI,887,1035,1182,1478,1848,2956,4434
Logan Gilbert,SEA,878,1025,1171,1464,1830,2928,4392
Elly De La Cruz,CIN,869,1014,1158,1448,1810,2896,4344
Jazz Chisholm Jr.,MIA,869,1014,1158,1448,1810,2896,4344
Luke Weaver,NYY,863,1007,1150,1438,1798,2876,4314
Jackson Chourio,MIL,862,1005,1149,1436,1795,2872,4308
Anthony Santander,BAL,860,1004,1147,1434,1793,2868,4302
Seth Lugo,KC,857,1000,1142,1428,1785,2856,4284
Ketel Marte,ARI,853,995,1138,1422,1778,2844,4266
William Contreras,MIL,852,994,1136,1420,1775,2840,4260
Michael King,SD,851,993,1134,1418,1773,2836,4254
Chris Sale,ATL,847,988,1130,1412,1765,2824,4236
Corbin Burnes,BAL,846,987,1128,1410,1763,2820,4230
Salvador Perez,KC,838,977,1117,1396,1745,2792,4188
Jack Flaherty,DET,829,967,1106,1382,1728,2764,4146
Robert Suarez,SD,824,962,1099,1374,1718,2748,4122
Tanner Scott,MIA,823,960,1098,1372,1715,2744,4116
Dylan Cease,SD,822,959,1096,1370,1713,2740,4110
Jurickson Profar,SD,821,958,1094,1368,1710,2736,4104
Bryan Reynolds,PIT,820,956,1093,1366,1708,2732,4098
Cade Smith,CLE,814,949,1085,1356,1695,2712,4068
Matt Olson,ATL,810,945,1080,1350,1688,2700,4050
Fernando Tatis Jr.,SD,809,944,1078,1348,1685,2696,4044
Eugenio Suarez,ARI,808,942,1077,1346,1683,2692,4038
Corbin Carroll,ARI,802,935,1069,1336,1670,2672,4008
Rafael Devers,BOS,800,934,1067,1334,1668,2668,4002
Ezequiel Tovar,COL,797,930,1062,1328,1660,2656,3984
Lane Thomas,CLE,792,924,1056,1320,1650,2640,3960
Carlos Rodon,NYY,788,920,1051,1314,1643,2628,3942
Josh Hader,HOU,780,910,1040,1300,1625,2600,3900
Matt Chapman,SF,778,907,1037,1296,1620,2592,3888
Riley Greene,DET,774,903,1032,1290,1613,2580,3870
Kyle Finnegan,WAS,762,889,1016,1270,1588,2540,3810
Steven Kwan,CLE,762,889,1016,1270,1588,2540,3810
Kirby Yates,TEX,761,888,1014,1268,1585,2536,3804
Jose Altuve,HOU,761,888,1014,1268,1585,2536,3804
Hunter Brown,HOU,761,888,1014,1268,1585,2536,3804
Tyler Holton,DET,760,886,1013,1266,1583,2532,3798
Ian Happ,CHC,757,883,1010,1262,1578,2524,3786
Vinnie Pasquantino,KC,756,882,1008,1260,1575,2520,3780
Jason Adam,SD,755,881,1006,1258,1573,2516,3774
Griffin Jax,MIN,754,879,1005,1256,1570,2512,3768
Ryan Walker,SF,752,878,1003,1254,1568,2508,3762
Jesse Winker,NYM,751,876,1002,1252,1565,2504,3756
Zach Neto,LAA,744,868,992,1240,1550,2480,3720
Alex Bregman,HOU,744,868,992,1240,1550,2480,3720
Yainer Diaz,HOU,744,868,992,1240,1550,2480,3720
Alex Verdugo,NYY,744,868,992,1240,1550,2480,3720
Framber Valdez,HOU,742,865,989,1236,1545,2472,3708
Bailey Ober,MIN,740,864,987,1234,1543,2468,3702
Cal Raleigh,SEA,739,862,986,1232,1540,2464,3696
Spencer Steer,CIN,734,857,979,1224,1530,2448,3672
Tanner Bibee,CLE,734,857,979,1224,1530,2448,3672
Lucas Erceg,KC,732,854,976,1220,1525,2440,3660
Bryan Abreu,HOU,730,851,973,1216,1520,2432,3648
Bryce Miller,SEA,727,848,970,1212,1515,2424,3636
Logan Webb,SF,726,847,968,1210,1513,2420,3630
Oneil Cruz,PIT,722,843,963,1204,1505,2408,3612
Aaron Nola,PHI,720,840,960,1200,1500,2400,3600
Hunter Gaddis,CLE,720,840,960,1200,1500,2400,3600
Luis Severino,NYM,720,840,960,1200,1500,2400,3600
Seiya Suzuki,CHC,714,833,952,1190,1488,2380,3570
Alec Bohm,PHI,714,833,952,1190,1488,2380,3570
Trea Turner,PHI,714,833,952,1190,1488,2380,3570
Cristopher Sanchez,PHI,712,830,949,1186,1483,2372,3558
Alex Vesia,LAD,712,830,949,1186,1483,2372,3558
Shota Imanaga,CHC,706,823,941,1176,1470,2352,3528
Brenton Doyle,COL,704,822,939,1174,1468,2348,3522
Garrett Crochet,CHW,704,822,939,1174,1468,2348,3522
Edwin Diaz,NYM,704,822,939,1174,1468,2348,3522
Taylor Ward,LAA,702,819,936,1170,1463,2340,3510
Masyn Winn,STL,700,816,933,1166,1458,2332,3498
Jake Cronenworth,SD,700,816,933,1166,1458,2332,3498
Jose Quintana,NYM,700,816,933,1166,1458,2332,3498
Corey Seager,TEX,698,815,931,1164,1455,2328,3492
Gerrit Cole,NYY,696,812,928,1160,1450,2320,3480
Julio Rodriguez,SEA,695,811,926,1158,1448,2316,3474
JJ Bleday,OAK,694,809,925,1156,1445,2312,3468
Christian Walker,ARI,691,806,922,1152,1440,2304,3456
Mason Miller,OAK,691,806,922,1152,1440,2304,3456
Yusei Kikuchi,HOU,691,806,922,1152,1440,2304,3456
Luis Arraez,MIA,691,806,922,1152,1440,2304,3456
Marcus Semien,TEX,690,805,920,1150,1438,2300,3450
Jason Foley,DET,688,802,917,1146,1433,2292,3438
Jorge Soler,ATL,688,802,917,1146,1433,2292,3438
Brendan Donovan,STL,683,797,910,1138,1423,2276,3414
Evan Phillips,LAD,683,797,910,1138,1423,2276,3414
Isaac Paredes,CHC,680,794,907,1134,1418,2268,3402
George Kirby,SEA,679,792,906,1132,1415,2264,3396
Paul Goldschmidt,STL,679,792,906,1132,1415,2264,3396
Cody Bellinger,CHC,678,791,904,1130,1413,2260,3390
Freddy Peralta,MIL,674,787,899,1124,1405,2248,3372
Brice Turang,MIL,674,787,899,1124,1405,2248,3372
Will Vest,DET,674,787,899,1124,1405,2248,3372
Wyatt Langford,TEX,673,785,898,1122,1403,2244,3366
Brandon Pfaadt,ARI,672,784,896,1120,1400,2240,3360
CJ Abrams,WAS,672,784,896,1120,1400,2240,3360
Max Fried,ATL,672,784,896,1120,1400,2240,3360
Andres Gimenez,CLE,671,783,894,1118,1398,2236,3354
Adolis Garcia,TEX,665,776,886,1108,1385,2216,3324
Enrique Hernandez,LAD,665,776,886,1108,1385,2216,3324
David Fry,CLE,664,774,885,1106,1383,2212,3318
Ronel Blanco,HOU,662,773,883,1104,1380,2208,3312
Michael Busch,CHC,660,770,880,1100,1375,2200,3300
Jeff Hoffman,PHI,660,770,880,1100,1375,2200,3300
Jeremy Pena,HOU,660,770,880,1100,1375,2200,3300
Matt Vierling,DET,660,770,880,1100,1375,2200,3300
Jake Burger,MIA,659,769,878,1098,1373,2196,3294
Pablo Lopez,MIN,656,766,875,1094,1368,2188,3282
Paul Skenes,PIT,656,766,875,1094,1368,2188,3282
Alec Burleson,STL,654,763,872,1090,1363,2180,3270
Michael Kopech,CHW,654,763,872,1090,1363,2180,3270
Kenley Jansen,BOS,653,762,870,1088,1360,2176,3264
Carlos Santana,MIN,652,760,869,1086,1358,2172,3258
Gavin Lux,LAD,652,760,869,1086,1358,2172,3258
Sonny Gray,STL,649,757,866,1082,1353,2164,3246
Dansby Swanson,CHC,648,756,864,1080,1350,2160,3240
Maikel Garcia,KC,648,756,864,1080,1350,2160,3240
Aroldis Chapman,PIT,647,755,862,1078,1348,2156,3234
Adley Rutschman,BAL,646,753,861,1076,1345,2152,3228
Andrew Vaughn,CHW,646,753,861,1076,1345,2152,3228
Hunter Greene,CIN,646,753,861,1076,1345,2152,3228
Jonathan India,CIN,643,750,858,1072,1340,2144,3216
Nolan Arenado,STL,643,750,858,1072,1340,2144,3216
Joe Jimenez,ATL,643,750,858,1072,1340,2144,3216
Kevin Gausman,TOR,640,746,853,1066,1333,2132,3198
Willi Castro,MIN,638,745,851,1064,1330,2128,3192
David Robertson,TEX,637,743,850,1062,1328,2124,3186
Nathaniel Lowe,TEX,637,743,850,1062,1328,2124,3186
Yandy Diaz,TB,637,743,850,1062,1328,2124,3186
Colton Cowser,BAL,637,743,850,1062,1328,2124,3186
Josh Bell,ARI,636,742,848,1060,1325,2120,3180
Heliot Ramos,SF,635,741,846,1058,1323,2116,3174
Tanner Houck,BOS,635,741,846,1058,1323,2116,3174
Luis Gil,NYY,634,739,845,1056,1320,2112,3168
Starling Marte,NYM,634,739,845,1056,1320,2112,3168
Colt Keith,DET,631,736,842,1052,1315,2104,3156
Josh Smith,TEX,630,735,840,1050,1313,2100,3150
Nico Hoerner,CHC,630,735,840,1050,1313,2100,3150
Luis Garcia Jr.,WAS,628,732,837,1046,1308,2092,3138
Blake Treinen,LAD,626,731,835,1044,1305,2088,3132
Jose Berrios,TOR,625,729,834,1042,1303,2084,3126
Camilo Doval,SF,624,728,832,1040,1300,2080,3120
George Springer,TOR,622,725,829,1036,1295,2072,3108
Randy Arozarena,SEA,620,724,827,1034,1293,2068,3102
Tyler O'Neill,BOS,620,724,827,1034,1293,2068,3102
Michael Wacha,KC,620,724,827,1034,1293,2068,3102
Nick Martinez,CIN,619,722,826,1032,1290,2064,3096
Shea Langeliers,OAK,619,722,826,1032,1290,2064,3096
Brady Singer,KC,618,721,824,1030,1288,2060,3090
Ryan McMahon,COL,617,720,822,1028,1285,2056,3084
Tyler Rogers,SF,617,720,822,1028,1285,2056,3084
Cedric Mullins,BAL,617,720,822,1028,1285,2056,3084
Bryson Stott,PHI,617,720,822,1028,1285,2056,3084
J.D. Martinez,NYM,617,720,822,1028,1285,2056,3084
Andres Munoz,SEA,616,718,821,1026,1283,2052,3078
Kutter Crawford,BOS,616,718,821,1026,1283,2052,3078
Tyler Stephenson,CIN,616,718,821,1026,1283,2052,3078
Carlos Estevez,LAA,616,718,821,1026,1283,2052,3078
Ryne Stanek,NYM,616,718,821,1026,1283,2052,3078
Tim Herrin,CLE,614,717,819,1024,1280,2048,3072
Bryan De La Cruz,MIA,613,715,818,1022,1278,2044,3066
Nathan Eovaldi,TEX,612,714,816,1020,1275,2040,3060
Hector Neris,CHC,612,714,816,1020,1275,2040,3060
Phil Maton,NYM,608,710,811,1014,1268,2028,3042
Max Muncy,LAD,608,710,811,1014,1268,2028,3042
Andrew Kittredge,STL,607,708,810,1012,1265,2024,3036
Jesus Sanchez,MIA,606,707,808,1010,1263,2020,3030
Luis Castillo,SEA,606,707,808,1010,1263,2020,3030
Nestor Cortes,NYY,606,707,808,1010,1263,2020,3030
Joc Pederson,ARI,605,706,806,1008,1260,2016,3024
Lourdes Gurriel Jr.,ARI,602,703,803,1004,1255,2008,3012
Ceddanne Rafaela,BOS,601,701,802,1002,1253,2004,3006
Tyler Glasnow,LAD,600,700,800,1000,1250,2000,3000
Zach Eflin,BAL,599,699,798,998,1248,1996,2994
Trevor Megill,MIL,599,699,798,998,1248,1996,2994
MacKenzie Gore,WAS,596,696,795,994,1243,1988,2982
Reynaldo Lopez,ATL,596,696,795,994,1243,1988,2982
Austin Wells,NYY,596,696,795,994,1243,1988,2982
Nolan Schanuel,LAA,593,692,790,988,1235,1976,2964
Erick Fedde,CHW,590,689,787,984,1230,1968,2952
Rhys Hoskins,MIL,590,689,787,984,1230,1968,2952
Lawrence Butler,OAK,587,685,782,978,1223,1956,2934
David Peterson,NYM,587,685,782,978,1223,1956,2934
Kerry Carpenter,DET,584,682,779,974,1218,1948,2922
Yoshinobu Yamamoto,LAD,584,682,779,974,1218,1948,2922
Jake Irvin,WAS,583,680,778,972,1215,1944,2916
Ranger Suarez,PHI,583,680,778,972,1215,1944,2916
Brendan Rodgers,COL,580,676,773,966,1208,1932,2898
Ryan O'Hearn,BAL,578,675,771,964,1205,1928,2892
Andrew Benintendi,CHW,576,672,768,960,1200,1920,2880
Daniel Hudson,LAD,575,671,766,958,1198,1916,2874
Andrew Heaney,TEX,571,666,762,952,1190,1904,2856
Michael Conforto,SF,568,662,757,946,1183,1892,2838
John Schreiber,KC,568,662,757,946,1183,1892,2838
Tommy Edman,LAD,568,662,757,946,1183,1892,2838
Zack Littell,TB,566,661,755,944,1180,1888,2832
Tobias Myers,MIL,566,661,755,944,1180,1888,2832
Michael Harris II,ATL,566,661,755,944,1180,1888,2832
Craig Kimbrel,BAL,565,659,754,942,1178,1884,2826
Jhoan Duran,MIN,565,659,754,942,1178,1884,2826
Chris Bassitt,TOR,563,657,750,938,1173,1876,2814
Kevin Ginkel,ARI,562,655,749,936,1170,1872,2808
Mike Yastrzemski,SF,560,654,747,934,1168,1868,2802
Zac Gallen,ARI,560,654,747,934,1168,1868,2802
Luke Raley,SEA,559,652,746,932,1165,1864,2796
Mitch Keller,PIT,559,652,746,932,1165,1864,2796
Wilyer Abreu,BOS,559,652,746,932,1165,1864,2796
Jake McCarthy,ARI,558,651,744,930,1163,1860,2790
Derek Law,WAS,557,650,742,928,1160,1856,2784
Kyle Gibson,STL,557,650,742,928,1160,1856,2784
Luis L. Ortiz,PIT,556,648,741,926,1158,1852,2778
Joel Payamps,MIL,556,648,741,926,1158,1852,2778
Alexis Diaz,CIN,553,645,738,922,1153,1844,2766
Charlie Morton,ATL,553,645,738,922,1153,1844,2766
Spencer Arrighetti,HOU,553,645,738,922,1153,1844,2766
Tyler Kinley,COL,553,645,738,922,1153,1844,2766
Andy Pages,LAD,552,644,736,920,1150,1840,2760
Jameson Taillon,CHC,550,641,733,916,1145,1832,2748
Ryan Mountcastle,BAL,548,640,731,914,1143,1828,2742
Daulton Varsho,TOR,545,636,726,908,1135,1816,2724
Fernando Cruz,CIN,545,636,726,908,1135,1816,2724
JP Sears,OAK,545,636,726,908,1135,1816,2724
Joe Ryan,MIN,545,636,726,908,1135,1816,2724
Brandon Marsh,PHI,544,634,725,906,1133,1812,2718
Austin Riley,ATL,540,630,720,900,1125,1800,2700
Joey Ortiz,MIL,539,629,718,898,1123,1796,2694
Justin Steele,CHC,539,629,718,898,1123,1796,2694
Dylan Floro,ARI,538,627,717,896,1120,1792,2688
Logan O'Hoppe,LAA,538,627,717,896,1120,1792,2688
Robert Garcia,WAS,538,627,717,896,1120,1792,2688
Jordan Westburg,BAL,538,627,717,896,1120,1792,2688
Xander Bogaerts,SD,538,627,717,896,1120,1792,2688
Brayan Bello,BOS,534,623,712,890,1113,1780,2670
Colin Rea,MIL,534,623,712,890,1113,1780,2670
Andrew McCutchen,PIT,533,622,710,888,1110,1776,2664
Nick Pivetta,BOS,533,622,710,888,1110,1776,2664
Byron Buxton,MIN,532,620,709,886,1108,1772,2658
Christopher Morel,CHC,532,620,709,886,1108,1772,2658
Keegan Akin,BAL,532,620,709,886,1108,1772,2658
Aaron Civale,MIL,532,620,709,886,1108,1772,2658
A.J. Puk,ARI,529,617,706,882,1103,1764,2646
Justin Turner,SEA,529,617,706,882,1103,1764,2646
Taj Bradley,TB,529,617,706,882,1103,1764,2646
Brayan Rocchio,CLE,528,616,704,880,1100,1760,2640
Connor Wong,BOS,524,612,699,874,1093,1748,2622
Carlos Correa,MIN,523,610,698,872,1090,1744,2616
Mitchell Parker,WAS,523,610,698,872,1090,1744,2616
Frankie Montas,CIN,523,610,698,872,1090,1744,2616
Blake Snell,SF,522,609,696,870,1088,1740,2610
Michael Toglia,COL,522,609,696,870,1088,1740,2610
Tyler Anderson,LAA,522,609,696,870,1088,1740,2610
Tommy Pham,CHW,522,609,696,870,1088,1740,2610
Pete Fairbanks,TB,518,605,691,864,1080,1728,2592
Jose Alvarado,PHI,517,603,690,862,1078,1724,2586
Leody Taveras,TEX,517,603,690,862,1078,1724,2586
Scott Barlow,CLE,517,603,690,862,1078,1724,2586
Ryne Nelson,ARI,515,601,686,858,1073,1716,2574
Ty France,CIN,514,599,685,856,1070,1712,2568
Charlie Blackmon,COL,512,598,683,854,1068,1708,2562
MJ Melendez,KC,512,598,683,854,1068,1708,2562
Reese Olson,DET,510,595,680,850,1063,1700,2550
Brandon Lowe,TB,508,592,677,846,1058,1692,2538
Kyle Isbel,KC,508,592,677,846,1058,1692,2538
Jo Adell,LAA,506,591,675,844,1055,1688,2532
Kyle Tucker,HOU,506,591,675,844,1055,1688,2532
Paul DeJong,CHW,504,588,672,840,1050,1680,2520
Ryan Feltner,COL,504,588,672,840,1050,1680,2520
Orlando Arcia,ATL,504,588,672,840,1050,1680,2520
Harrison Bader,NYM,504,588,672,840,1050,1680,2520
Dennis Santana,NYY,503,587,670,838,1048,1676,2514
Ernie Clement,TOR,503,587,670,838,1048,1676,2514
David Bednar,PIT,502,585,669,836,1045,1672,2508
Sal Frelick,MIL,502,585,669,836,1045,1672,2508
Garrett Cleavinger,TB,500,584,667,834,1043,1668,2502
Ryan Jeffers,MIN,500,584,667,834,1043,1668,2502
Jeff McNeil,NYM,500,584,667,834,1043,1668,2502
Masataka Yoshida,BOS,499,582,666,832,1040,1664,2496
Jeimer Candelario,CIN,498,581,664,830,1038,1660,2490
Ryan Pepiot,TB,498,581,664,830,1038,1660,2490
Mark Leiter Jr.,CHC,498,581,664,830,1038,1660,2490
Jake Meyers,HOU,497,580,662,828,1035,1656,2484
Yennier Cano,BAL,494,577,659,824,1030,1648,2472
Matt Strahm,PHI,494,577,659,824,1030,1648,2472
Zack Gelof,OAK,493,575,658,822,1028,1644,2466
Reed Garrett,NYM,491,573,654,818,1023,1636,2454
Chad Green,TOR,490,571,653,816,1020,1632,2448
Seranthony Dominguez,BAL,488,570,651,814,1018,1628,2442
Bryan Woo,SEA,487,568,650,812,1015,1624,2436
Matthew Liberatore,STL,487,568,650,812,1015,1624,2436
Francisco Alvarez,NYM,487,568,650,812,1015,1624,2436
Tommy Kahnle,NYY,484,564,645,806,1008,1612,2418
Austin Gomber,COL,481,561,642,802,1003,1604,2406
Ryan Thompson,ARI,480,560,640,800,1000,1600,2400
Jeremiah Estrada,SD,480,560,640,800,1000,1600,2400
Kyle Higashioka,SD,480,560,640,800,1000,1600,2400
Gavin Stone,LAD,479,559,638,798,998,1596,2394
Tim Hill,CHW,479,559,638,798,998,1596,2394
Yu Darvish,SD,479,559,638,798,998,1596,2394
Justin Martinez,ARI,478,557,637,796,995,1592,2388
Patrick Corbin,WAS,476,556,635,794,993,1588,2382
Jose Miranda,MIN,475,554,634,792,990,1584,2376
Kevin Kelly,TB,474,553,632,790,988,1580,2370
Miles Mikolas,STL,474,553,632,790,988,1580,2370
Michael Massey,KC,474,553,632,790,988,1580,2370
Andre Pallante,STL,472,550,629,786,983,1572,2358
Ha-Seong Kim,SD,472,550,629,786,983,1572,2358
Isiah Kiner-Falefa,PIT,472,550,629,786,983,1572,2358
Jonah Heim,TEX,472,550,629,786,983,1572,2358
Jose Caballero,TB,472,550,629,786,983,1572,2358
Spencer Schwellenbach,ATL,470,549,627,784,980,1568,2352
Trevor Larnach,MIN,469,547,626,782,978,1564,2346
Hunter Strickland,LAA,468,546,624,780,975,1560,2340
JoJo Romero,STL,466,543,621,776,970,1552,2328
Jose Leclerc,TEX,466,543,621,776,970,1552,2328
Albert Suarez,BAL,464,542,619,774,968,1548,2322
Cole Sands,MIN,464,542,619,774,968,1548,2322
Beau Brieske,DET,464,542,619,774,968,1548,2322
Joe Mantiply,ARI,463,540,618,772,965,1544,2316
Jose Siri,TB,463,540,618,772,965,1544,2316
Angel Zerpa,KC,463,540,618,772,965,1544,2316
Jarred Kelenic,ATL,462,539,616,770,963,1540,2310
Mitch Spence,OAK,462,539,616,770,963,1540,2310
Wenceel Perez,DET,462,539,616,770,963,1540,2310
Dean Kremer,BAL,461,538,614,768,960,1536,2304
Nick Mears,COL,461,538,614,768,960,1536,2304
Hunter Renfroe,KC,458,535,611,764,955,1528,2292
Javier Assad,CHC,458,535,611,764,955,1528,2292
Ozzie Albies,ATL,458,535,611,764,955,1528,2292
Parker Meadows,DET,456,532,608,760,950,1520,2280
Seth Brown,OAK,455,531,606,758,948,1516,2274
Gregory Soto,BAL,455,531,606,758,948,1516,2274
Aaron Bummer,ATL,455,531,606,758,948,1516,2274
T.J. McFarland,OAK,452,528,603,754,943,1508,2262
Pete Crow-Armstrong,CHC,451,526,602,752,940,1504,2256
Rowdy Tellez,PIT,451,526,602,752,940,1504,2256
Blake Perkins,MIL,451,526,602,752,940,1504,2256
Keibert Ruiz,WAS,450,525,600,750,938,1500,2250
Lars Nootbaar,STL,449,524,598,748,935,1496,2244
J.T. Realmuto,PHI,449,524,598,748,935,1496,2244
Ben Lively,CLE,449,524,598,748,935,1496,2244
Griffin Canning,LAA,448,522,597,746,933,1492,2238
Jorge Polanco,SEA,448,522,597,746,933,1492,2238
Dylan Moore,SEA,446,521,595,744,930,1488,2232
Nate Pearson,CHC,446,521,595,744,930,1488,2232
Anthony Banda,LAD,446,521,595,744,930,1488,2232
Jacob Young,WAS,445,519,594,742,928,1484,2226
Jose Soriano,LAA,445,519,594,742,928,1484,2226
Ryan Pressly,HOU,445,519,594,742,928,1484,2226
Joe Musgrove,SD,445,519,594,742,928,1484,2226
Spencer Torkelson,DET,445,519,594,742,928,1484,2226
Bowden Francis,TOR,443,517,590,738,923,1476,2214
Mickey Moniak,LAA,443,517,590,738,923,1476,2214
Mauricio Dubon,HOU,443,517,590,738,923,1476,2214
Orion Kerkering,PHI,443,517,590,738,923,1476,2214
Gavin Sheets,CHW,442,515,589,736,920,1472,2208
LaMonte Wade Jr.,SF,442,515,589,736,920,1472,2208
Tayler Scott,HOU,442,515,589,736,920,1472,2208
James McArthur,KC,440,514,587,734,918,1468,2202
Taylor Rogers,SF,440,514,587,734,918,1468,2202
Michael Lorenzen,KC,440,514,587,734,918,1468,2202
Will Smith,KC,440,514,587,734,918,1468,2202
Jon Singleton,HOU,438,511,584,730,913,1460,2190
Trent Thornton,SEA,437,510,582,728,910,1456,2184
Pierce Johnson,ATL,437,510,582,728,910,1456,2184
Erik Miller,SF,436,508,581,726,908,1452,2178
Simeon Woods Richardson,MIN,434,507,579,724,905,1448,2172
Victor Vodnik,COL,434,507,579,724,905,1448,2172
Tyrone Taylor,NYM,434,507,579,724,905,1448,2172
Spencer Horwitz,TOR,433,505,578,722,903,1444,2166
Matt Waldron,SD,431,503,574,718,898,1436,2154
Michael Tonkin,MIN,431,503,574,718,898,1436,2154
Christian Yelich,MIL,430,501,573,716,895,1432,2148
Trevor Richards,MIN,428,500,571,714,893,1428,2142
Jacob Webb,BAL,428,500,571,714,893,1428,2142
Gio Urshela,ATL,427,498,570,712,890,1424,2136
Grayson Rodriguez,BAL,427,498,570,712,890,1424,2136
Bryan Hudson,MIL,426,497,568,710,888,1420,2130
Otto Lopez,MIA,426,497,568,710,888,1420,2130
Yuki Matsui,SD,426,497,568,710,888,1420,2130
Andrew Abbott,CIN,425,496,566,708,885,1416,2124
Jared Jones,PIT,425,496,566,708,885,1416,2124
Jorge Lopez,CHC,425,496,566,708,885,1416,2124
Mitch Garver,SEA,425,496,566,708,885,1416,2124
Bailey Falter,PIT,424,494,565,706,883,1412,2118
Jalen Beeks,COL,422,493,563,704,880,1408,2112
Jose Butto,NYM,421,491,562,702,878,1404,2106
Alejandro Kirk,TOR,420,490,560,700,875,1400,2100
Geraldo Perdomo,ARI,420,490,560,700,875,1400,2100
Anthony Rizzo,NYY,420,490,560,700,875,1400,2100
Nolan Gorman,STL,418,487,557,696,870,1392,2088
Pedro Avila,CLE,418,487,557,696,870,1392,2088
Jake Rogers,DET,418,487,557,696,870,1392,2088
John Brebbia,ATL,416,486,555,694,868,1388,2082
Marcus Stroman,NYY,416,486,555,694,868,1388,2082
Caleb Ferguson,HOU,416,486,555,694,868,1388,2082
Adam Ottavino,NYM,415,484,554,692,865,1384,2076
Andrew Chafin,DET,415,484,554,692,865,1384,2076
Anthony Bender,MIA,414,483,552,690,863,1380,2070
Josh Rojas,SEA,414,483,552,690,863,1380,2070
Andrew Nardi,MIA,410,479,547,684,855,1368,2052
Willson Contreras,STL,410,479,547,684,855,1368,2052
Luis Robert Jr.,CHW,409,477,546,682,853,1364,2046
Tanner Banks,CHW,409,477,546,682,853,1364,2046
Bo Naylor,CLE,409,477,546,682,853,1364,2046
Hoby Milner,MIL,408,476,544,680,850,1360,2040
Nick Gonzales,PIT,408,476,544,680,850,1360,2040
Jared Triolo,PIT,407,475,542,678,848,1356,2034
Randal Grichuk,ARI,407,475,542,678,848,1356,2034
Ryan Yarbrough,LAD,407,475,542,678,848,1356,2034
Chris Flexen,CHW,404,472,539,674,843,1348,2022
Davis Schneider,TOR,404,472,539,674,843,1348,2022
Kyle Harrison,SF,404,472,539,674,843,1348,2022
Patrick Bailey,SF,404,472,539,674,843,1348,2022
Tyler Fitzgerald,SF,404,472,539,674,843,1348,2022
Mark Canha,DET,403,470,538,672,840,1344,2016
Nick Sandlin,CLE,403,470,538,672,840,1344,2016
Cionel Perez,BAL,402,469,536,670,838,1340,2010
Genesis Cabrera,TOR,402,469,536,670,838,1340,2010
Alec Marsh,KC,401,468,534,668,835,1336,2004
Max Schuemann,OAK,401,468,534,668,835,1336,2004
Clarke Schmidt,NYY,400,466,533,666,833,1332,1998
Justin Wilson,CIN,398,465,531,664,830,1328,1992
Jake Bauers,MIL,398,465,531,664,830,1328,1992
Josh Lowe,TB,396,462,528,660,825,1320,1980
Nick Lodolo,CIN,396,462,528,660,825,1320,1980
Colin Holderman,PIT,395,461,526,658,823,1316,1974
J.P. Crawford,SEA,394,459,525,656,820,1312,1968
Nicky Lopez,CHW,394,459,525,656,820,1312,1968
Paul Sewald,ARI,394,459,525,656,820,1312,1968
Buck Farmer,CIN,392,458,523,654,818,1308,1962
Luis Garcia,BOS,391,456,522,652,815,1304,1956
Will Benson,CIN,391,456,522,652,815,1304,1956
Caleb Thielbar,MIN,390,455,520,650,813,1300,1950
Declan Cronin,MIA,389,454,518,648,810,1296,1944
Gabriel Moreno,ARI,389,454,518,648,810,1296,1944
Santiago Espinal,CIN,389,454,518,648,810,1296,1944
James Wood,WAS,388,452,517,646,808,1292,1938
Ryan Fernandez,STL,388,452,517,646,808,1292,1938
Travis d'Arnaud,ATL,388,452,517,646,808,1292,1938
Miguel Amaya,CHC,386,451,515,644,805,1288,1932
Calvin Faucher,MIA,385,449,514,642,803,1284,1926
Jose Iglesias,NYM,384,448,512,640,800,1280,1920
Jake Cave,COL,383,447,510,638,798,1276,1914
Mitch Haniger,SEA,383,447,510,638,798,1276,1914
David Peralta,SD,382,445,509,636,795,1272,1908
Connor Joe,PIT,380,444,507,634,793,1268,1902
Lance Lynn,STL,380,444,507,634,793,1268,1902
Martin Perez,PIT,380,444,507,634,793,1268,1902
Victor Robles,SEA,380,444,507,634,793,1268,1902
TJ Friedl,CIN,379,442,506,632,790,1264,1896
Ramon Urias,BAL,379,442,506,632,790,1264,1896
Xavier Edwards,MIA,378,441,504,630,788,1260,1890
Joey Estes,OAK,377,440,502,628,785,1256,1884
Jose Urena,TEX,377,440,502,628,785,1256,1884
Max Kepler,MIN,377,440,502,628,785,1256,1884
Rob Refsnyder,BOS,377,440,502,628,785,1256,1884
Zach McKinstry,DET,377,440,502,628,785,1256,1884
Jon Gray,TEX,376,438,501,626,783,1252,1878
Will Brennan,CLE,376,438,501,626,783,1252,1878
Greg Weissert,BOS,374,437,499,624,780,1248,1872
Tyler Ferguson,OAK,374,437,499,624,780,1248,1872
Hunter Harvey,KC,373,435,498,622,778,1244,1866
Korey Lee,CHW,373,435,498,622,778,1244,1866
Sean Hjelle,SF,372,434,496,620,775,1240,1860
Kyle Hendricks,CHC,371,433,494,618,773,1236,1854
Luke Jackson,ATL,371,433,494,618,773,1236,1854
Jorge Alcala,MIN,368,430,491,614,768,1228,1842
Ramon Laureano,ATL,368,430,491,614,768,1228,1842
Royce Lewis,MIN,368,430,491,614,768,1228,1842
Enyel De Los Santos,CHW,367,428,490,612,765,1224,1836
Thairo Estrada,SF,367,428,490,612,765,1224,1836
Chris Martin,BOS,366,427,488,610,763,1220,1830
Elias Diaz,COL,366,427,488,610,763,1220,1830
Donovan Solano,SD,366,427,488,610,763,1220,1830
Luis Rengifo,LAA,364,424,485,606,758,1212,1818
Tyson Miller,CHC,364,424,485,606,758,1212,1818
Jared Koenig,MIL,364,424,485,606,758,1212,1818
Austin Voth,SEA,362,423,483,604,755,1208,1812
Edward Cabrera,MIA,362,423,483,604,755,1208,1812
Dylan Lee,ATL,362,423,483,604,755,1208,1812
Walker Buehler,LAD,362,423,483,604,755,1208,1812
Porter Hodge,CHC,361,421,482,602,753,1204,1806
Carson Fulmer,LAA,360,420,480,600,750,1200,1800
Freddy Fermin,KC,358,417,477,596,745,1192,1788
Jake Fraley,CIN,358,417,477,596,745,1192,1788
Mike Tauchman,CHC,358,417,477,596,745,1192,1788
Joey Wentz,DET,356,416,475,594,743,1188,1782
Miguel Rojas,LAD,356,416,475,594,743,1188,1782
Bryse Wilson,MIL,353,412,470,588,735,1176,1764
Tim Mayza,NYY,352,410,469,586,733,1172,1758
Austin Adams,OAK,350,409,467,584,730,1168,1752
David Hamilton,BOS,350,409,467,584,730,1168,1752
Lenyn Sosa,CHW,350,409,467,584,730,1168,1752
John King,STL,349,407,466,582,728,1164,1746
Jesse Chavez,ATL,349,407,466,582,728,1164,1746
Lucas Sims,BOS,347,405,462,578,723,1156,1734
Manuel Rodriguez,TB,347,405,462,578,723,1156,1734
Garrett Mitchell,MIL,347,405,462,578,723,1156,1734
Adrian Morejon,SD,343,400,458,572,715,1144,1716
Cal Quantrill,COL,342,399,456,570,713,1140,1710
Joey Bart,PIT,342,399,456,570,713,1140,1710
Jonah Bride,MIA,342,399,456,570,713,1140,1710
Johan Rojas,PHI,342,399,456,570,713,1140,1710
Yimi Garcia,SEA,341,398,454,568,710,1136,1704
Matt Wallner,MIN,340,396,453,566,708,1132,1698
Roansy Contreras,LAA,337,393,450,562,703,1124,1686
Chris Stratton,KC,336,392,448,560,700,1120,1680
Jakob Junis,CIN,336,392,448,560,700,1120,1680
Amed Rosario,CIN,335,391,446,558,698,1116,1674
Justin Anderson,CHW,332,388,443,554,693,1108,1662
Colin Poche,TB,331,386,442,552,690,1104,1656
Jacob Barnes,WAS,331,386,442,552,690,1104,1656
Jonathan Cannon,CHW,329,384,438,548,685,1096,1644
Ryan Weathers,MIA,329,384,438,548,685,1096,1644
Trevor Rogers,BAL,329,384,438,548,685,1096,1644
Jordan Hicks,SF,328,382,437,546,683,1092,1638
Kevin Pillar,CHW,328,382,437,546,683,1092,1638
Devin Williams,MIL,328,382,437,546,683,1092,1638
Eli Morgan,CLE,328,382,437,546,683,1092,1638
Mike Baumann,BAL,325,379,434,542,678,1084,1626
Sam Long,KC,325,379,434,542,678,1084,1626
Justin Lawrence,COL,324,378,432,540,675,1080,1620
Tyler Freeman,CLE,324,378,432,540,675,1080,1620
DJ Herz,WAS,323,377,430,538,673,1076,1614
Oswaldo Cabrera,NYY,320,374,427,534,668,1068,1602
Andy Ibanez,DET,320,374,427,534,668,1068,1602
Cooper Criswell,BOS,319,372,426,532,665,1064,1596
Emmanuel Rivera,BAL,319,372,426,532,665,1064,1596
Sam Moll,CIN,319,372,426,532,665,1064,1596
Manuel Margot,MIN,318,371,424,530,663,1060,1590
Shelby Miller,DET,318,371,424,530,663,1060,1590
Gary Sanchez,MIL,318,371,424,530,663,1060,1590
Brent Suter,CIN,317,370,422,528,660,1056,1584
Landon Knack,LAD,317,370,422,528,660,1056,1584
Jacob Stallings,COL,316,368,421,526,658,1052,1578
Dominic Smith,BOS,314,367,419,524,655,1048,1572
James Paxton,BOS,314,367,419,524,655,1048,1572
Kenta Maeda,DET,314,367,419,524,655,1048,1572
Shawn Armstrong,CHC,314,367,419,524,655,1048,1572
Matthew Boyd,CLE,314,367,419,524,655,1048,1572
Abraham Toro,OAK,312,364,416,520,650,1040,1560
Justin Slaten,BOS,312,364,416,520,650,1040,1560
Tyler Alexander,TB,311,363,414,518,648,1036,1554
Edmundo Sosa,PHI,311,363,414,518,648,1036,1554
Tylor Megill,NYM,311,363,414,518,648,1036,1554
Brennan Bernardino,BOS,308,360,411,514,643,1028,1542
Hunter Stratton,PIT,308,360,411,514,643,1028,1542
Kevin Newman,ARI,308,360,411,514,643,1028,1542
Shane Baz,TB,308,360,411,514,643,1028,1542
Zack Kelly,BOS,308,360,411,514,643,1028,1542
Grant Holmes,ATL,307,358,410,512,640,1024,1536
Ivan Herrera,STL,307,358,410,512,640,1024,1536
Tanner Rainey,WAS,307,358,410,512,640,1024,1536
Zach Pop,TOR,307,358,410,512,640,1024,1536
Jhonkensy Noel,CLE,306,357,408,510,638,1020,1530
Carson Kelly,DET,305,356,406,508,635,1016,1524
Jason Heyward,HOU,305,356,406,508,635,1016,1524
Burch Smith,BAL,302,353,403,504,630,1008,1512
Randy Vasquez,SD,302,353,403,504,630,1008,1512
Triston Casas,BOS,302,353,403,504,630,1008,1512
Cody Bradford,TEX,301,351,402,502,628,1004,1506
Luis Campusano,SD,300,350,400,500,625,1000,1500
Edwin Uceta,TB,299,349,398,498,623,996,1494
Kyle Nicolas,PIT,298,347,397,496,620,992,1488
Alex Faedo,DET,296,346,395,494,618,988,1482
Cole Irvin,BAL,296,346,395,494,618,988,1482
Jonny DeLuca,TB,296,346,395,494,618,988,1482
Joey Meneses,WAS,294,343,392,490,613,980,1470
Kyle Freeland,COL,293,342,390,488,610,976,1464
Danny Coulombe,BAL,293,342,390,488,610,976,1464
Jake Cousins,NYY,293,342,390,488,610,976,1464
Casey Mize,DET,292,340,389,486,608,972,1458
Jordan Montgomery,ARI,292,340,389,486,608,972,1458
Jesus Tinoco,CHC,290,339,387,484,605,968,1452
Michel Otanez,OAK,289,337,386,482,603,964,1446
Romy Gonzalez,BOS,289,337,386,482,603,964,1446
Chris Paddack,MIN,288,336,384,480,600,960,1440
Whit Merrifield,ATL,286,333,381,476,595,952,1428
Ildemaro Vargas,WAS,284,332,379,474,593,948,1422
Keider Montero,DET,284,332,379,474,593,948,1422
Bo Bichette,TOR,283,330,378,472,590,944,1416
Richie Palacios,TB,283,330,378,472,590,944,1416
Trevor Williams,WAS,283,330,378,472,590,944,1416
Adam Duvall,ATL,282,329,376,470,588,940,1410
Matt Moore,LAA,282,329,376,470,588,940,1410
Michael Soroka,CHW,282,329,376,470,588,940,1410
Miguel Andujar,OAK,282,329,376,470,588,940,1410
Joe Ross,MIL,282,329,376,470,588,940,1410
Danny Jansen,BOS,281,328,374,468,585,936,1404
Eloy Jimenez,BAL,281,328,374,468,585,936,1404
Ben Rortvedt,TB,280,326,373,466,583,932,1398
Juan Yepez,WAS,280,326,373,466,583,932,1398
Ke'Bryan Hayes,PIT,280,326,373,466,583,932,1398
Patrick Sandoval,LAA,280,326,373,466,583,932,1398
Victor Caratini,HOU,278,325,371,464,580,928,1392
Ben Brown,CHC,277,323,370,462,578,924,1386
Elvis Peguero,MIL,277,323,370,462,578,924,1386
Emilio Pagan,CIN,277,323,370,462,578,924,1386
Erik Swanson,TOR,277,323,370,462,578,924,1386
Nick Fortes,MIA,277,323,370,462,578,924,1386
Michael Siani,STL,276,322,368,460,575,920,1380
A.J. Minter,ATL,275,321,366,458,573,916,1374
Osvaldo Bido,OAK,274,319,365,456,570,912,1368
Garrett Hampson,KC,274,319,365,456,570,912,1368
Collin Snider,SEA,272,318,363,454,568,908,1362
Jake Diekman,NYM,272,318,363,454,568,908,1362
Javier Baez,DET,272,318,363,454,568,908,1362
Danny Young,NYM,272,318,363,454,568,908,1362
Jacob Latz,TEX,271,316,362,452,565,904,1356
Ryan Brasier,LAD,271,316,362,452,565,904,1356
Eddie Rosario,ATL,270,315,360,450,563,900,1350
Landen Roupp,SF,270,315,360,450,563,900,1350
Yariel Rodriguez,TOR,270,315,360,450,563,900,1350
Kyle Manzardo,CLE,270,315,360,450,563,900,1350
Brendon Little,TOR,269,314,358,448,560,896,1344
Rafael Montero,HOU,269,314,358,448,560,896,1344
Kris Bubic,KC,269,314,358,448,560,896,1344
Drew Smyly,CHC,268,312,357,446,558,892,1338
Hayden Wesneski,CHC,268,312,357,446,558,892,1338
Reid Detmers,LAA,268,312,357,446,558,892,1338
Adam Frazier,KC,268,312,357,446,558,892,1338
Cam Booser,BOS,266,311,355,444,555,888,1332
Kevin Kiermaier,LAD,266,311,355,444,555,888,1332
Chris Taylor,LAD,266,311,355,444,555,888,1332
Gavin Williams,CLE,265,309,354,442,553,884,1326
Josh Winckowski,BOS,265,309,354,442,553,884,1326
Randy Rodriguez,SF,265,309,354,442,553,884,1326
Tayler Saucedo,SEA,264,308,352,440,550,880,1320
Yohan Ramirez,BAL,264,308,352,440,550,880,1320
Stephen Kolek,SD,263,307,350,438,548,876,1314
Dedniel Nunez,NYM,262,305,349,436,545,872,1308
Stuart Fairchild,CIN,262,305,349,436,545,872,1308
Ben Joyce,LAA,260,304,347,434,543,868,1302
Michael Grove,LAD,260,304,347,434,543,868,1302
Nick Gordon,MIA,260,304,347,434,543,868,1302
Huascar Brazoban,MIA,259,302,346,432,540,864,1296
Jose Trevino,NYY,259,302,346,432,540,864,1296
Scott Alexander,OAK,258,301,344,430,538,860,1290
Carmen Mlodzinski,PIT,257,300,342,428,535,856,1284
Christian Vazquez,MIN,257,300,342,428,535,856,1284
Jose Ruiz,PHI,257,300,342,428,535,856,1284
Nolan Jones,COL,257,300,342,428,535,856,1284
Austin Hays,BAL,256,298,341,426,533,852,1278
Hayden Birdsong,SF,256,298,341,426,533,852,1278
Pavin Smith,ARI,254,297,339,424,530,848,1272
Bryan Hoeing,MIA,254,297,339,424,530,848,1272
Brett Wisely,SF,253,295,338,422,528,844,1266
James McCann,BAL,253,295,338,422,528,844,1266
Nick Anderson,KC,253,295,338,422,528,844,1266
Bryce Jarvis,ARI,252,294,336,420,525,840,1260
Carlos Carrasco,CLE,252,294,336,420,525,840,1260
Yasmani Grandal,PIT,252,294,336,420,525,840,1260
Justyn-Henry Malloy,DET,252,294,336,420,525,840,1260
Hunter Goodman,COL,251,293,334,418,523,836,1254
Jose Suarez,LAA,251,293,334,418,523,836,1254
Justin Verlander,HOU,251,293,334,418,523,836,1254
Wandy Peralta,SD,250,291,333,416,520,832,1248
Willie Calhoun,LAA,248,290,331,414,518,828,1242
Vidal Brujan,MIA,247,288,330,412,515,824,1236
Edouard Julien,MIN,246,287,328,410,513,820,1230
Ezequiel Duran,TEX,246,287,328,410,513,820,1230
Jack Suwinski,PIT,246,287,328,410,513,820,1230
Cade Povich,BAL,244,284,325,406,508,812,1218
Joe Kelly,LAD,244,284,325,406,508,812,1218
Dane Dunning,TEX,242,283,323,404,505,808,1212
JT Chargois,MIA,242,283,323,404,505,808,1212
Jesus Luzardo,MIA,242,283,323,404,505,808,1212
Ian Hamilton,NYY,242,283,323,404,505,808,1212
Joey Gallo,WAS,241,281,322,402,503,804,1206
Austin Martin,MIN,240,280,320,400,500,800,1200
Jose A. Ferrer,WAS,240,280,320,400,500,800,1200
Kyle Farmer,MIN,240,280,320,400,500,800,1200
Sean Murphy,ATL,240,280,320,400,500,800,1200
Hogan Harris,OAK,239,279,318,398,498,796,1194
Chas McCormick,HOU,239,279,318,398,498,796,1194
Harold Ramirez,TB,238,277,317,396,495,792,1188
Joey Loperfido,HOU,238,277,317,396,495,792,1188
Brant Hurter,DET,238,277,317,396,495,792,1188
Merrill Kelly,ARI,236,276,315,394,493,788,1182
Nelson Velazquez,KC,236,276,315,394,493,788,1182
Spencer Turnbull,PHI,236,276,315,394,493,788,1182
Trent Grisham,NYY,235,274,314,392,490,784,1176
Jared Shuster,CHW,234,273,312,390,488,780,1170
Seth Martinez,HOU,233,272,310,388,485,776,1164
Tyler Soderstrom,OAK,233,272,310,388,485,776,1164
Ross Stripling,OAK,232,270,309,386,483,772,1158
Chase Anderson,BOS,230,269,307,384,480,768,1152
Dylan Carlson,STL,230,269,307,384,480,768,1152
Carson Spiers,CIN,229,267,306,382,478,764,1146
Paul Blackburn,NYM,229,267,306,382,478,764,1146
Pedro Pages,STL,229,267,306,382,478,764,1146
Michael A. Taylor,PIT,228,266,304,380,475,760,1140
Tyler Nevin,OAK,227,265,302,378,473,756,1134
Connor Norby,BAL,226,263,301,376,470,752,1128
Enmanuel Valdez,BOS,226,263,301,376,470,752,1128
Jordan Weems,WAS,224,262,299,374,468,748,1122
Nick Senzel,CHW,224,262,299,374,468,748,1122
Richard Lovelady,CHC,224,262,299,374,468,748,1122
David Festa,MIN,223,260,298,372,465,744,1116
Jake Bird,COL,223,260,298,372,465,744,1116
Wilmer Flores,SF,222,259,296,370,463,740,1110
Sam Hilliard,COL,221,258,294,368,460,736,1104
Steven Okert,MIN,220,256,293,366,458,732,1098
Anthony Molina,COL,218,255,291,364,455,728,1092
Triston McKenzie,CLE,217,253,290,362,453,724,1086
Addison Barger,TOR,216,252,288,360,450,720,1080
Ronald Acuna Jr.,ATL,216,252,288,360,450,720,1080
Shawn Dubin,HOU,216,252,288,360,450,720,1080
Elehuris Montero,COL,215,251,286,358,448,716,1074
Kyle Leahy,STL,214,249,285,356,445,712,1068
Luke Little,CHC,214,249,285,356,445,712,1068
Chris Roycroft,STL,211,246,282,352,440,704,1056
Jorge Mateo,BAL,211,246,282,352,440,704,1056
Tony Santillan,CIN,210,245,280,350,438,700,1050
Daniel Schneemann,CLE,209,244,278,348,435,696,1044
Spencer Bivens,SF,208,242,277,346,433,692,1038
Dakota Hudson,COL,206,241,275,344,430,688,1032
Taylor Walls,TB,204,238,272,340,425,680,1020
Brandon Drury,LAA,202,235,269,336,420,672,1008
Steven Wilson,CHW,202,235,269,336,420,672,1008
Peter Lambert,COL,199,232,266,332,415,664,996
Michael Kelly,OAK,198,231,264,330,413,660,990
Gabe Speier,SEA,197,230,262,328,410,656,984
Robbie Grossman,CHW,197,230,262,328,410,656,984
Yency Almonte,CHC,197,230,262,328,410,656,984
Chad Kuhl,CHW,196,228,261,326,408,652,978
Derek Hill,MIA,196,228,261,326,408,652,978
Austin Slater,BAL,196,228,261,326,408,652,978
Daysbel Hernandez,ATL,196,228,261,326,408,652,978
Kyle Bradish,BAL,194,227,259,324,405,648,972
DJ LeMahieu,NYY,193,225,258,322,403,644,966
Junior Caminero,TB,193,225,258,322,403,644,966
Valente Bellozo,MIA,193,225,258,322,403,644,966
Jackson Holliday,BAL,192,224,256,320,400,640,960
Cavan Biggio,ATL,191,223,254,318,398,636,954
Leo Jimenez,TOR,191,223,254,318,398,636,954
Graham Ashcraft,CIN,190,221,253,316,395,632,948
Ben Rice,NYY,188,220,251,314,393,628,942
Jordan Leasure,CHW,188,220,251,314,393,628,942
Anthony Rendon,LAA,185,216,246,308,385,616,924
Carlos Hernandez,KC,184,214,245,306,383,612,918
Dillon Tate,BAL,184,214,245,306,383,612,918
Jack Kochanowicz,LAA,184,214,245,306,383,612,918
Slade Cecconi,ARI,184,214,245,306,383,612,918
Alex Kirilloff,MIN,182,213,243,304,380,608,912
Angel Chivilli,COL,182,213,243,304,380,608,912
Keegan Thompson,CHC,181,211,242,302,378,604,906
Patrick Wisdom,CHC,181,211,242,302,378,604,906
Kyle Stowers,BAL,180,210,240,300,375,600,900
Noelvi Marte,CIN,180,210,240,300,375,600,900
Jonathan Hernandez,SEA,179,209,238,298,373,596,894
Daniel Lynch IV,KC,178,207,237,296,370,592,888
Edward Olivares,PIT,178,207,237,296,370,592,888
Sean Guenther,DET,178,207,237,296,370,592,888
Christian Bethancourt,CHC,176,206,235,294,368,588,882
Ryan Burr,TOR,176,206,235,294,368,588,882
Brooks Lee,MIN,175,204,234,292,365,584,876
Josh Jung,TEX,174,203,232,290,363,580,870
Kody Funderburk,MIN,174,203,232,290,363,580,870
Matt Bowman,ARI,174,203,232,290,363,580,870
Dairon Blanco,KC,174,203,232,290,363,580,870
Alex Lange,DET,173,202,230,288,360,576,864
Adam Cimber,LAA,172,200,229,286,358,572,858
Evan Carter,TEX,172,200,229,286,358,572,858
Blaze Alexander,ARI,170,199,227,284,355,568,852
Jordan Walker,STL,170,199,227,284,355,568,852
Keaton Winn,SF,170,199,227,284,355,568,852
Brenan Hanifee,DET,170,199,227,284,355,568,852
Kyle Muller,OAK,169,197,226,282,353,564,846
Jhony Brito,SD,168,196,224,280,350,560,840
Roddery Munoz,MIA,168,196,224,280,350,560,840
Thyago Vieira,ARI,168,196,224,280,350,560,840
Dominic Canzone,SEA,167,195,222,278,348,556,834
Kody Clemens,PHI,167,195,222,278,348,556,834
Nick Martini,CIN,166,193,221,276,345,552,828
Brent Honeywell,LAD,166,193,221,276,345,552,828
Fraser Ellard,CHW,164,192,219,274,343,548,822
Grant Anderson,TEX,164,192,219,274,343,548,822
Jonathan Aranda,TB,164,192,219,274,343,548,822
Adrian Houser,NYM,163,190,218,272,340,544,816
Brock Burke,LAA,163,190,218,272,340,544,816
DJ Stewart,NYM,163,190,218,272,340,544,816
Miguel Vargas,CHW,163,190,218,272,340,544,816
Eduardo Salazar,LAD,162,189,216,270,338,540,810
Nick Ahmed,LAD,162,189,216,270,338,540,810
Dominic Fletcher,CHW,161,188,214,268,335,536,804
Joe Boyle,OAK,160,186,213,266,333,532,798
Angel Martinez,CLE,157,183,210,262,328,524,786
Sean Reid-Foley,NYM,157,183,210,262,328,524,786
Alex Call,WAS,156,182,208,260,325,520,780
Dany Jimenez,OAK,156,182,208,260,325,520,780
Drew Rasmussen,TB,156,182,208,260,325,520,780
Giovanny Gallegos,STL,156,182,208,260,325,520,780
Trey Sweeney,DET,156,182,208,260,325,520,780
Gus Varland,CHW,155,181,206,258,323,516,774
Joey Cantillo,CLE,155,181,206,258,323,516,774
Erik Sabrowski,CLE,155,181,206,258,323,516,774
Matt Thaiss,LAA,152,178,203,254,318,508,762
Bryan King,HOU,152,178,203,254,318,508,762
Davis Martin,CHW,151,176,202,252,315,504,756
Garrett Stubbs,PHI,151,176,202,252,315,504,756
Matt Carpenter,STL,151,176,202,252,315,504,756
Taijuan Walker,PHI,151,176,202,252,315,504,756
Xzavion Curry,CLE,151,176,202,252,315,504,756
Drew Thorpe,CHW,150,175,200,250,313,500,750
Josh Staumont,MIN,150,175,200,250,313,500,750
Mike Trout,LAA,150,175,200,250,313,500,750
Victor Gonzalez,NYY,150,175,200,250,313,500,750
Daz Cameron,OAK,149,174,198,248,310,496,744
Eduard Bazardo,SEA,149,174,198,248,310,496,744
Emerson Hancock,SEA,149,174,198,248,310,496,744
Luis Matos,SF,149,174,198,248,310,496,744
Corey Julks,CHW,148,172,197,246,308,492,738
Dane Myers,MIA,148,172,197,246,308,492,738
Jerar Encarnacion,SF,148,172,197,246,308,492,738
Gabriel Arias,CLE,146,171,195,244,305,488,732
Quinn Priester,BOS,146,171,195,244,305,488,732
Austin Barnes,LAD,145,169,194,242,303,484,726
Brett Baty,NYM,145,169,194,242,303,484,726
Cristian Pache,BAL,145,169,194,242,303,484,726
Eduardo Rodriguez,ARI,145,169,194,242,303,484,726
Jose Tena,CLE,145,169,194,242,303,484,726
Kyle McCann,OAK,145,169,194,242,303,484,726
Sam Hentges,CLE,145,169,194,242,303,484,726
Travis Jankowski,TEX,144,168,192,240,300,480,720
Ty Blach,COL,144,168,192,240,300,480,720
Bryce Elder,ATL,143,167,190,238,298,476,714
Tim Anderson,MIA,143,167,190,238,298,476,714
Cristian Javier,HOU,142,165,189,236,295,472,708
Josh Fleming,PIT,142,165,189,236,295,472,708
Max Scherzer,TEX,142,165,189,236,295,472,708
Seth Halvorsen,COL,142,165,189,236,295,472,708
Christian Scott,NYM,139,162,186,232,290,464,696
Jordan Wicks,CHC,139,162,186,232,290,464,696
Reese McGuire,BOS,139,162,186,232,290,464,696
Andruw Monasterio,MIL,137,160,182,228,285,456,684
Andres Chaparro,WAS,137,160,182,228,285,456,684
Casey Schmitt,SF,137,160,182,228,285,456,684
Grant Holman,OAK,137,160,182,228,285,456,684
Adrian Del Castillo,ARI,136,158,181,226,283,452,678
Drew Smith,NYM,136,158,181,226,283,452,678
Luis Urias,SEA,136,158,181,226,283,452,678
George Soriano,MIA,134,157,179,224,280,448,672
Hans Crouse,LAA,134,157,179,224,280,448,672
Trey Lipscomb,WAS,134,157,179,224,280,448,672
Luis Guillorme,ARI,132,154,176,220,275,440,660
Robbie Ray,SF,132,154,176,220,275,440,660
Troy Taylor,SEA,132,154,176,220,275,440,660
Aaron Ashby,MIL,131,153,174,218,273,436,654
Luis Torrens,NYM,130,151,173,216,270,432,648
Ethan Roberts,CHC,128,150,171,214,268,428,642
Jordan Beck,COL,128,150,171,214,268,428,642
DL Hall,MIL,126,147,168,210,263,420,630
Jose Quijada,LAA,126,147,168,210,263,420,630
Kris Bryant,COL,126,147,168,210,263,420,630
Scott McGough,ARI,126,147,168,210,263,420,630
Grant McCray,SF,125,146,166,208,260,416,624
Brock Stewart,MIN,124,144,165,206,258,412,618
Josh Sborz,TEX,124,144,165,206,258,412,618
Nick Loftin,KC,124,144,165,206,258,412,618
Austin Hedges,CLE,124,144,165,206,258,412,618
Hunter Bigge,CHC,122,143,163,204,255,408,612
Kaleb Ort,HOU,122,143,163,204,255,408,612
Adbert Alzolay,CHC,121,141,162,202,253,404,606
Ron Marinaccio,NYY,121,141,162,202,253,404,606
Tyler Wade,SD,120,140,160,200,250,400,600
Braxton Garrett,MIA,119,139,158,198,248,396,594
Jeffrey Springs,TB,119,139,158,198,248,396,594
J.D. Davis,NYY,118,137,157,196,245,392,588
Jordan Romano,TOR,118,137,157,196,245,392,588
Jung Hoo Lee,SF,118,137,157,196,245,392,588
Logan Allen,ARI,118,137,157,196,245,392,588
J.T. Ginn,OAK,115,134,154,192,240,384,576
Jay Jackson,MIN,115,134,154,192,240,384,576
Tomas Nido,CHC,115,134,154,192,240,384,576
Trevor Story,BOS,115,134,154,192,240,384,576
Tyler Phillips,PHI,114,133,152,190,238,380,570
Heston Kjerstad,BAL,113,132,150,188,235,376,564
Prelander Berroa,CHW,113,132,150,188,235,376,564
Victor Scott II,STL,113,132,150,188,235,376,564
Weston Wilson,PHI,113,132,150,188,235,376,564
Abner Uribe,MIL,112,130,149,186,233,372,558
Brad Keller,BOS,112,130,149,186,233,372,558
Griffin Conine,MIA,112,130,149,186,233,372,558
Rhett Lowder,CIN,112,130,149,186,233,372,558
Robert Gasser,MIL,112,130,149,186,233,372,558
Alex Jackson,TB,110,129,147,184,230,368,552
Bobby Miller,LAD,110,129,147,184,230,368,552
Ryder Ryan,PIT,110,129,147,184,230,368,552
Anthony Maldonado,MIA,109,127,146,182,228,364,546
Enoli Paredes,CHC,109,127,146,182,228,364,546
Tom Cosgrove,SD,109,127,146,182,228,364,546
Danny Mendick,CHW,108,126,144,180,225,360,540
Dominic Leone,CHW,108,126,144,180,225,360,540
James Outman,LAD,108,126,144,180,225,360,540
Yuli Gurriel,KC,108,126,144,180,225,360,540
Bryan Ramos,CHW,107,125,142,178,223,356,534
Darren McCaughan,CLE,107,125,142,178,223,356,534
Estevan Florial,CLE,107,125,142,178,223,356,534
Max Meyer,MIA,107,125,142,178,223,356,534
Yunior Marte,PHI,107,125,142,178,223,356,534
Christian Encarnacion-Strand,CIN,106,123,141,176,220,352,528
Sean Bouchard,COL,106,123,141,176,220,352,528
Alek Thomas,ARI,104,122,139,174,218,348,522
Darell Hernaiz,OAK,104,122,139,174,218,348,522
Dylan Crews,WAS,104,122,139,174,218,348,522
Louie Varland,MIN,104,122,139,174,218,348,522
Michael McGreevy,STL,104,122,139,174,218,348,522
Steven Matz,STL,104,122,139,174,218,348,522
Andrew Walters,CLE,104,122,139,174,218,348,522
Alek Manoah,TOR,103,120,138,172,215,344,516
Bryan Baker,BAL,103,120,138,172,215,344,516
Chris Devenski,TB,103,120,138,172,215,344,516
Aaron Schunk,COL,102,119,136,170,213,340,510
Ronny Henriquez,MIN,102,119,136,170,213,340,510
Adam Oller,MIA,101,118,134,168,210,336,504
Clayton Kershaw,LAD,101,118,134,168,210,336,504
Jose Cisnero,LAA,101,118,134,168,210,336,504
Luis Medina,OAK,101,118,134,168,210,336,504
Ben Casparius,LAD,101,118,134,168,210,336,504
Brooks Baldwin,CHW,100,116,133,166,208,332,498
Eric Haase,MIL,100,116,133,166,208,332,498
Jose Herrera,ARI,100,116,133,166,208,332,498
Curtis Mead,TB,98,115,131,164,205,328,492
Justin Wrobleski,LAD,98,115,131,164,205,328,492
Nathan Lukes,TOR,98,115,131,164,205,328,492
Rece Hinds,CIN,98,115,131,164,205,328,492
Zebby Matthews,MIN,98,115,131,164,205,328,492
Luke Maile,CIN,97,113,130,162,203,324,486
Riley Adams,WAS,97,113,130,162,203,324,486
Alex Young,CIN,96,112,128,160,200,320,480
Erasmo Ramirez,TB,96,112,128,160,200,320,480
Ryan Zeferjahn,LAA,96,112,128,160,200,320,480
Will Wagner,TOR,96,112,128,160,200,320,480
Sixto Sanchez,MIA,95,111,126,158,198,316,474
Curt Casali,SF,92,108,123,154,193,308,462
Emmanuel Ramirez,MIA,92,108,123,154,193,308,462
Nick Burdi,NYY,92,108,123,154,193,308,462
Joshua Palacios,PIT,91,106,122,152,190,304,456
Niko Kavadas,LAA,91,106,122,152,190,304,456
Tommy Nance,TOR,91,106,122,152,190,304,456
Brandon Bielak,HOU,90,105,120,150,188,300,450
Sean Reynolds,SD,90,105,120,150,188,300,450
Ben Gamel,HOU,89,104,118,148,185,296,444
Jeff Criswell,COL,89,104,118,148,185,296,444
Marco Gonzales,PIT,89,104,118,148,185,296,444
Martin Maldonado,CHW,89,104,118,148,185,296,444
Michael Stefanic,LAA,89,104,118,148,185,296,444
Nick Vespi,BAL,89,104,118,148,185,296,444
Shane Bieber,CLE,89,104,118,148,185,296,444
Yilber Diaz,ARI,89,104,118,148,185,296,444
Brett Harris,OAK,88,102,117,146,183,292,438
Garrett Cooper,BOS,88,102,117,146,183,292,438
Julian Aguiar,CIN,88,102,117,146,183,292,438
Ryan Bliss,SEA,88,102,117,146,183,292,438
Alex Cobb,CLE,88,102,117,146,183,292,438
Brady Basso,OAK,86,101,115,144,180,288,432
Bryan Sammons,DET,86,101,115,144,180,288,432
Colten Brewer,CHC,86,101,115,144,180,288,432
Gerson Garabito,TEX,86,101,115,144,180,288,432
River Ryan,LAD,86,101,115,144,180,288,432
Jacob Wilson,OAK,85,99,114,142,178,284,426
Sean Burke,CHW,85,99,114,142,178,284,426
Jon Berti,NYY,85,99,114,142,178,284,426
Alek Jacob,SD,85,99,114,142,178,284,426
Daniel Palencia,CHC,84,98,112,140,175,280,420
Joe La Sorsa,WAS,84,98,112,140,175,280,420
Jace Jung,DET,84,98,112,140,175,280,420
Mason Montgomery,TB,83,97,110,138,173,276,414
Ryan Miller,LAA,83,97,110,138,173,276,414
Trey Cabbage,HOU,83,97,110,138,173,276,414
Brooks Raley,NYM,82,95,109,136,170,272,408
Cody Poteet,NYY,82,95,109,136,170,272,408
Davis Daniel,LAA,82,95,109,136,170,272,408
John McMillon,MIA,82,95,109,136,170,272,408
John Means,BAL,82,95,109,136,170,272,408
Nick Nastrini,CHW,82,95,109,136,170,272,408
Mason Black,SF,79,92,106,132,165,264,396
Matt Manning,DET,79,92,106,132,165,264,396
Deivi Garcia,CHW,78,91,104,130,163,260,390
Alex Wood,OAK,77,90,102,128,160,256,384
Dillon Dingler,DET,77,90,102,128,160,256,384
Eric Wagaman,LAA,77,90,102,128,160,256,384
Guillo Zuniga,LAA,77,90,102,128,160,256,384
Jose Marte,LAA,77,90,102,128,160,256,384
Michael Petersen,LAD,77,90,102,128,160,256,384
Tyler Beede,CLE,77,90,102,128,160,256,384
Yerry Rodriguez,TEX,77,90,102,128,160,256,384
Daniel Vogelbach,TOR,76,88,101,126,158,252,378
Jose Cuas,CHC,76,88,101,126,158,252,378
Nick Sogard,BOS,76,88,101,126,158,252,378
Jake Woodford,CHW,74,87,99,124,155,248,372
Julian Merryweather,CHC,74,87,99,124,155,248,372
Matt Festa,NYM,74,87,99,124,155,248,372
Scott Blewett,MIN,74,87,99,124,155,248,372
Spencer Howard,CLE,74,87,99,124,155,248,372
Tanner Gordon,COL,74,87,99,124,155,248,372
Brandon Hughes,ARI,73,85,98,122,153,244,366
Cole Sulser,NYM,73,85,98,122,153,244,366
Lake Bachar,MIA,73,85,98,122,153,244,366
Mason Englert,DET,73,85,98,122,153,244,366
Miguel Sano,LAA,73,85,98,122,153,244,366
Vaughn Grissom,BOS,72,84,96,120,150,240,360
Brusdar Graterol,LAD,72,84,96,120,150,240,360
Kyle Nelson,ARI,71,83,94,118,148,236,354
Leo Rivas,SEA,71,83,94,118,148,236,354
Rafael Marchan,PHI,71,83,94,118,148,236,354
Garrett Whitlock,BOS,70,81,93,116,145,232,348
Luis Peralta,COL,70,81,93,116,145,232,348
Matt Sauer,KC,70,81,93,116,145,232,348
Cody Bolton,SEA,68,80,91,114,143,228,342
Jack Leiter,TEX,68,80,91,114,143,228,342
Oliver Dunn,MIL,68,80,91,114,143,228,342
Richard Fitts,BOS,68,80,91,114,143,228,342
Jasson Dominguez,NYY,68,80,91,114,143,228,342
Bligh Madris,DET,67,78,90,112,140,224,336
Kyle Tyler,MIA,67,78,90,112,140,224,336
Tommy Henry,ARI,67,78,90,112,140,224,336
Tucker Barnhart,ARI,67,78,90,112,140,224,336
Zach DeLoach,CHW,67,78,90,112,140,224,336
Eguy Rosario,SD,66,77,88,110,138,220,330
Jack Lopez,LAA,66,77,88,110,138,220,330
Ryan Noda,OAK,66,77,88,110,138,220,330
Vinny Nittoli,BAL,66,77,88,110,138,220,330
Walter Pennington,KC,66,77,88,110,138,220,330
Yosver Zulueta,CIN,66,77,88,110,138,220,330
Zack Short,ATL,66,77,88,110,138,220,330
Jonatan Clase,SEA,65,76,86,108,135,216,324
Kevin Herget,MIL,65,76,86,108,135,216,324
Tyler Matzek,ATL,65,76,86,108,135,216,324
Akil Baddoo,DET,64,74,85,106,133,212,318
Luis Guerrero,BOS,64,74,85,106,133,212,318
Luken Baker,STL,64,74,85,106,133,212,318
Brett de Geus,MIA,62,73,83,104,130,208,312
Esteury Ruiz,OAK,62,73,83,104,130,208,312
Matt Barnes,WAS,62,73,83,104,130,208,312
Nasim Nunez,WAS,62,73,83,104,130,208,312
Zach Dezenzo,HOU,62,73,83,104,130,208,312
Henry Davis,PIT,61,71,82,102,128,204,306
Miles Mastrobuoni,CHC,61,71,82,102,128,204,306
Touki Toussaint,CHW,61,71,82,102,128,204,306
Alika Williams,PIT,60,70,80,100,125,200,300
Andrew Knizner,TEX,60,70,80,100,125,200,300
David Dahl,PHI,60,70,80,100,125,200,300
Luisangel Acuna,NYM,60,70,80,100,125,200,300
Ray Kerr,ATL,60,70,80,100,125,200,300
Edgardo Henriquez,LAD,60,70,80,100,125,200,300
Aaron Brooks,OAK,59,69,78,98,123,196,294
Cole Winn,TEX,59,69,78,98,123,196,294
Domingo German,PIT,59,69,78,98,123,196,294
Joely Rodriguez,BOS,59,69,78,98,123,196,294
Jose Azocar,SD,59,69,78,98,123,196,294
Jose Fermin,STL,59,69,78,98,123,196,294
Kent Emanuel,MIA,59,69,78,98,123,196,294
Nick Madrigal,CHC,59,69,78,98,123,196,294
Tristan Beck,SF,59,69,78,98,123,196,294
Billy Cook,PIT,58,67,77,96,120,192,288
Bryce Johnson,SD,58,67,77,96,120,192,288
Jose Abreu,HOU,58,67,77,96,120,192,288
Nick Allen,OAK,58,67,77,96,120,192,288
Jaden Hill,COL,56,66,75,94,118,188,282
Kenny Rosenberg,LAA,56,66,75,94,118,188,282
Kolby Allard,PHI,56,66,75,94,118,188,282
Marco Luciano,SF,56,66,75,94,118,188,282
Ty Madden,DET,56,66,75,94,118,188,282
Anthony Veneziano,KC,55,64,74,92,115,184,276
Bailey Horn,BOS,55,64,74,92,115,184,276
Elieser Hernandez,LAD,55,64,74,92,115,184,276
Kirby Snead,SEA,55,64,74,92,115,184,276
Bobby Dalbec,BOS,54,63,72,90,113,180,270
Brandon Crawford,STL,54,63,72,90,113,180,270
David Bote,CHC,53,62,70,88,110,176,264
Rob Zastryzny,MIL,53,62,70,88,110,176,264
David Hensley,MIA,52,60,69,86,108,172,258
Humberto Castellanos,ARI,52,60,69,86,108,172,258
J.P. Feyereisen,LAD,52,60,69,86,108,172,258
Sammy Peralta,CHW,52,60,69,86,108,172,258
J.B. Bukauskas,MIL,50,59,67,84,105,168,252
Jamie Westbrook,BOS,50,59,67,84,105,168,252
Jared Walsh,TEX,50,59,67,84,105,168,252
Logan Gillaspie,SD,50,59,67,84,105,168,252
Luke Williams,ATL,50,59,67,84,105,168,252
Ryan Borucki,PIT,50,59,67,84,105,168,252
Ali Sanchez,MIA,49,57,66,82,103,164,246
Gustavo Campero,LAA,49,57,66,82,103,164,246
Rene Pinto,TB,49,57,66,82,103,164,246
Yan Gomes,CHC,49,57,66,82,103,164,246
Josh Walker,NYM,48,56,64,80,100,160,240
Mitch White,MIL,48,56,64,80,100,160,240
Shay Whitcomb,HOU,48,56,64,80,100,160,240
Adam Mazur,SD,47,55,62,78,98,156,234
Blake Walston,ARI,47,55,62,78,98,156,234
Ji Hwan Bae,PIT,47,55,62,78,98,156,234
Peter Strzelecki,CLE,47,55,62,78,98,156,234
Kodai Senga,NYM,47,55,62,78,98,156,234
Mason McCoy,SD,46,53,61,76,95,152,228
Yonny Chirinos,MIA,46,53,61,76,95,152,228
Ben Heller,PIT,44,52,59,74,93,148,222
Bradley Blalock,COL,44,52,59,74,93,148,222
Brandon Williamson,CIN,44,52,59,74,93,148,222
Cal Stevenson,PHI,44,52,59,74,93,148,222
Drew Millas,WAS,44,52,59,74,93,148,222
Jahmai Jones,NYY,44,52,59,74,93,148,222
Nick Yorke,PIT,44,52,59,74,93,148,222
Ryan Kreidler,DET,44,52,59,74,93,148,222
Austin Warren,SF,43,50,58,72,90,144,216
Chadwick Tromp,ATL,43,50,58,72,90,144,216
Isaiah Campbell,BOS,43,50,58,72,90,144,216
Miguel Castro,ARI,43,50,58,72,90,144,216
Nick Robertson,STL,43,50,58,72,90,144,216
Eli White,ATL,42,49,56,70,88,140,210
J.P. France,HOU,42,49,56,70,88,140,210
Jairo Iriarte,CHW,42,49,56,70,88,140,210
Brian Serven,TOR,41,48,54,68,85,136,204
Cole Tucker,LAA,41,48,54,68,85,136,204
Gregory Santos,SEA,41,48,54,68,85,136,204
Jacob deGrom,TEX,41,48,54,68,85,136,204
Sam Aldegheri,LAA,41,48,54,68,85,136,204
Tyler Gilbert,PHI,41,48,54,68,85,136,204
Austin Shenton,TB,40,46,53,66,83,132,198
David Villar,SF,40,46,53,66,83,132,198
Jacob Hurtubise,CIN,40,46,53,66,83,132,198
Noah Davis,COL,40,46,53,66,83,132,198
Jimmy Herget,ATL,38,45,51,64,80,128,192
Kyren Paris,LAA,38,45,51,64,80,128,192
Luis Frias,ARI,38,45,51,64,80,128,192
Yoendrys Gomez,NYY,38,45,51,64,80,128,192
Cesar Salazar,HOU,37,43,50,62,78,124,186
Drew Romo,COL,37,43,50,62,78,124,186
Jacob Amaya,CHW,37,43,50,62,78,124,186
Jose E. Hernandez,PIT,37,43,50,62,78,124,186
Josh Winder,MIN,37,43,50,62,78,124,186
Kumar Rocker,TEX,37,43,50,62,78,124,186
Pablo Reyes,BOS,37,43,50,62,78,124,186
Parker Mushinski,HOU,37,43,50,62,78,124,186
Phil Bickford,NYY,37,43,50,62,78,124,186
Steven Cruz,KC,37,43,50,62,78,124,186
Tyler Wells,BAL,37,43,50,62,78,124,186
Chase Shugart,BOS,36,42,48,60,75,120,180
Jordyn Adams,LAA,36,42,48,60,75,120,180
Omar Narvaez,NYM,36,42,48,60,75,120,180
Tyler Locklear,SEA,36,42,48,60,75,120,180
Tyler Mahle,TEX,36,42,48,60,75,120,180
Avisail Garcia,MIA,35,41,46,58,73,116,174
Janson Junk,MIL,35,41,46,58,73,116,174
Ky Bush,CHW,35,41,46,58,73,116,174
Max Lazar,PHI,35,41,46,58,73,116,174
Tyler Black,MIL,35,41,46,58,73,116,174
Zach Remillard,CHW,35,41,46,58,73,116,174
Zack Thompson,STL,35,41,46,58,73,116,174
Buddy Kennedy,DET,34,39,45,56,70,112,168
Charles Leblanc,LAA,34,39,45,56,70,112,168
Steward Berroa,TOR,34,39,45,56,70,112,168
Thomas Saggese,STL,34,39,45,56,70,112,168
Aaron Hicks,LAA,32,38,43,54,68,108,162
Luis Contreras,HOU,32,38,43,54,68,108,162
Ryan Vilade,DET,32,38,43,54,68,108,162
Tyler Duffey,KC,32,38,43,54,68,108,162
Yoen Moncada,CHW,32,38,43,54,68,108,162
Amir Garrett,LAA,31,36,42,52,65,104,156
Braden Shewmake,CHW,31,36,42,52,65,104,156
Jacob Lopez,TB,31,36,42,52,65,104,156
Jordan Lyles,KC,30,35,40,50,63,100,150
Logan Driscoll,TB,30,35,40,50,63,100,150
Oscar Colas,CHW,30,35,40,50,63,100,150
Connor Gillispie,CLE,29,34,38,48,60,96,144
Dinelson Lamet,LAD,29,34,38,48,60,96,144
Jackson Rutledge,WAS,29,34,38,48,60,96,144
Johnathan Rodriguez,CLE,29,34,38,48,60,96,144
Jonathan Ornelas,TEX,29,34,38,48,60,96,144
Ricardo Pinto,PHI,29,34,38,48,60,96,144
Alexander Canario,CHC,28,32,37,46,58,92,138
Blake Sabol,SF,28,32,37,46,58,92,138
Chuckie Robinson,CHW,28,32,37,46,58,92,138
Jason Delay,PIT,28,32,37,46,58,92,138
Matt Carasiti,COL,28,32,37,46,58,92,138
Michael Mercado,PHI,28,32,37,46,58,92,138
Mike Clevinger,CHW,28,32,37,46,58,92,138
Mike Ford,CIN,28,32,37,46,58,92,138
Will Klein,KC,28,32,37,46,58,92,138
Alan Trejo,COL,26,31,35,44,55,88,132
Caleb Kilian,CHC,26,31,35,44,55,88,132
Casey Kelly,CIN,26,31,35,44,55,88,132
Colin Selby,BAL,26,31,35,44,55,88,132
Diego Castillo,MIN,26,31,35,44,55,88,132
Graham Pauley,SD,26,31,35,44,55,88,132
Joel Kuhnel,HOU,26,31,35,44,55,88,132
Nabil Crismatt,LAD,26,31,35,44,55,88,132
Nick Ramirez,LAD,26,31,35,44,55,88,132
Armando Alvarez,OAK,25,29,34,42,53,84,126
Jack Neely,CHC,25,29,34,42,53,84,126
Nick Hernandez,HOU,25,29,34,42,53,84,126
Riley O'Brien,STL,25,29,34,42,53,84,126
Spencer Strider,ATL,25,29,34,42,53,84,126
Trey Wingenter,BOS,25,29,34,42,53,84,126
Blake Dunn,CIN,24,28,32,40,50,80,120
Daulton Jefferies,PIT,24,28,32,40,50,80,120
Easton Lucas,DET,24,28,32,40,50,80,120
Forrest Wall,ATL,24,28,32,40,50,80,120
Jhonny Pereda,MIA,24,28,32,40,50,80,120
Joan Adon,WAS,24,28,32,40,50,80,120
Joey Lucchesi,NYM,24,28,32,40,50,80,120
Josh Maciejewski,NYY,24,28,32,40,50,80,120
Seby Zavala,SEA,24,28,32,40,50,80,120
Tom Murphy,SF,24,28,32,40,50,80,120
Billy McKinney,PIT,23,27,30,38,48,76,114
Matt Foster,CHW,23,27,30,38,48,76,114
Austin Davis,SD,22,25,29,36,45,72,108
Austin Wynns,CIN,22,25,29,36,45,72,108
Chase Silseth,LAA,22,25,29,36,45,72,108
Davis Wendzel,TEX,22,25,29,36,45,72,108
Isaac Mattson,PIT,22,25,29,36,45,72,108
Joey Wendle,NYM,22,25,29,36,45,72,108
Kyle Hurt,LAD,22,25,29,36,45,72,108
Stone Garrett,WAS,22,25,29,36,45,72,108
Wes Parsons,CLE,22,25,29,36,45,72,108
Will Warren,NYY,22,25,29,36,45,72,108
AJ Smith-Shawver,ATL,20,24,27,34,43,68,102
Dallas Keuchel,MIL,20,24,27,34,43,68,102
Darius Vines,ATL,20,24,27,34,43,68,102
Ehire Adrianza,LAA,20,24,27,34,43,68,102
Jack O'Loughlin,OAK,20,24,27,34,43,68,102
Jackson Jobe,DET,20,24,27,34,43,68,102
Jhonathan Diaz,SEA,20,24,27,34,43,68,102
Randy Dobnak,MIN,20,24,27,34,43,68,102
Ricky Vanasco,DET,20,24,27,34,43,68,102
Ryan McKenna,BAL,20,24,27,34,43,68,102
Sean Newcomb,OAK,20,24,27,34,43,68,102
Travis Blankenhorn,WAS,20,24,27,34,43,68,102
Gordon Graceffo,STL,19,22,26,32,40,64,96
Javier Sanoja,MIA,19,22,26,32,40,64,96
Nick Avila,SF,19,22,26,32,40,64,96
Shaun Anderson,MIA,19,22,26,32,40,64,96
Brandon Lockridge,SD,18,21,24,30,38,60,90
Caden Dana,LAA,18,21,24,30,38,60,90
Jason Vosler,SEA,18,21,24,30,38,60,90
Josh Rogers,COL,18,21,24,30,38,60,90
Owen Miller,MIL,18,21,24,30,38,60,90
Tyler Jay,MIL,18,21,24,30,38,60,90
Zach Penrod,BOS,18,21,24,30,38,60,90
Adael Amador,COL,17,20,22,28,35,56,84
Drew Waters,KC,17,20,22,28,35,56,84
Dustin Harris,TEX,17,20,22,28,35,56,84
Jake Bloss,HOU,17,20,22,28,35,56,84
Matt Andriese,MIA,17,20,22,28,35,56,84
Nick Nelson,PHI,17,20,22,28,35,56,84
Donovan Walton,SF,16,18,21,26,33,52,78
Tucker Davidson,BAL,16,18,21,26,33,52,78
Jacob Waguespack,TB,14,17,19,24,30,48,72
Naoyuki Uwasawa,BOS,14,17,19,24,30,48,72
Rich Hill,BOS,14,17,19,24,30,48,72
Trenton Brooks,SF,14,17,19,24,30,48,72
Zach Plesac,LAA,14,17,19,24,30,48,72
Carlos Rodriguez,MIL,13,15,18,22,28,44,66
Casey Legumina,CIN,13,15,18,22,28,44,66
Dan Altavilla,KC,13,15,18,22,28,44,66
Daniel Robert,TEX,13,15,18,22,28,44,66
Darren Baker,WAS,13,15,18,22,28,44,66
Diego A. Castillo,MIN,13,15,18,22,28,44,66
Jakson Reetz,SF,13,15,18,22,28,44,66
Jonathan Loaisiga,NYY,13,15,18,22,28,44,66
Justin Bruihl,PIT,13,15,18,22,28,44,66
Kai-Wei Teng,SF,13,15,18,22,28,44,66
Luis De Los Santos,TOR,13,15,18,22,28,44,66
Matt Mervis,CHC,13,15,18,22,28,44,66
Rafael Ortega,CHW,13,15,18,22,28,44,66
Trevor McDonald,SF,13,15,18,22,28,44,66
Brandon Eisert,TOR,12,14,16,20,25,40,60
Brett Sullivan,SD,12,14,16,20,25,40,60
Clayton Beeter,NYY,12,14,16,20,25,40,60
Daniel Duarte,MIN,12,14,16,20,25,40,60
Hunter Feduccia,LAD,12,14,16,20,25,40,60
Justin Sterner,TB,12,14,16,20,25,40,60
Justin Topa,MIN,12,14,16,20,25,40,60
Ty Adcock,NYM,12,14,16,20,25,40,60
Wade Miley,MIL,12,14,16,20,25,40,60
Zach Brzykcy,WAS,12,14,16,20,25,40,60
Coby Mayo,BAL,11,13,14,18,23,36,54
Eli Villalobos,MIA,11,13,14,18,23,36,54
Forrest Whitley,HOU,11,13,14,18,23,36,54
Jonathan Heasley,BAL,11,13,14,18,23,36,54
Jorge Barrosa,ARI,11,13,14,18,23,36,54
Oswald Peraza,NYY,11,13,14,18,23,36,54
Scott Effross,NYY,11,13,14,18,23,36,54
Aledmys Diaz,HOU,10,11,13,16,20,32,48
Antonio Senzatela,COL,10,11,13,16,20,32,48
Brent Headrick,MIN,10,11,13,16,20,32,48
Geoff Hartlieb,COL,10,11,13,16,20,32,48
Joey Wiemer,CIN,10,11,13,16,20,32,48
Liover Peguero,PIT,10,11,13,16,20,32,48
Matt Koch,COL,10,11,13,16,20,32,48
Tyler Heineman,BOS,10,11,13,16,20,32,48
Vladimir Gutierrez,MIA,10,11,13,16,20,32,48
DaShawn Keirsey Jr.,MIN,8,10,11,14,18,28,42
Greg Jones,COL,8,10,11,14,18,28,42
Jackson Stephens,ATL,8,10,11,14,18,28,42
Keston Hiura,LAA,8,10,11,14,18,28,42
Livan Soto,BAL,8,10,11,14,18,28,42
Michael Helman,MIN,8,10,11,14,18,28,42
Niko Goodrum,LAA,8,10,11,14,18,28,42
Pedro Leon,HOU,8,10,11,14,18,28,42
Tyler Zuber,TB,8,10,11,14,18,28,42
Adam Kloffenstein,STL,7,8,10,12,15,24,36
David Buchanan,CIN,7,8,10,12,15,24,36
David Fletcher,ATL,7,8,10,12,15,24,36
Johnny Cueto,LAA,7,8,10,12,15,24,36
Luis Vazquez,CHC,7,8,10,12,15,24,36
Mickey Gasper,BOS,7,8,10,12,15,24,36
Tejay Antone,CIN,7,8,10,12,15,24,36
Zach Logue,LAD,7,8,10,12,15,24,36
Austin Kitchen,MIA,6,7,8,10,13,20,30
Brandon Leibrandt,CIN,6,7,8,10,13,20,30
Bryan Shaw,CHW,6,7,8,10,13,20,30
Bubba Thompson,CIN,6,7,8,10,13,20,30
Carlos Narvaez,NYY,6,7,8,10,13,20,30
Chayce McDermott,BAL,6,7,8,10,13,20,30
Duke Ellis,CHW,6,7,8,10,13,20,30
Grant Hartwig,NYM,6,7,8,10,13,20,30
Isaac Collins,MIL,6,7,8,10,13,20,30
Justin Foscue,TEX,6,7,8,10,13,20,30
Mike Burrows,PIT,6,7,8,10,13,20,30
Riley Pint,COL,6,7,8,10,13,20,30
Tristan Gray,MIA,6,7,8,10,13,20,30
Alan Busenitz,CIN,5,6,6,8,10,16,24
Conner Capel,CIN,5,6,6,8,10,16,24
Dylan Coleman,HOU,5,6,6,8,10,16,24
Gerardo Reyes,OAK,5,6,6,8,10,16,24
J.P. Martinez,ATL,5,6,6,8,10,16,24
Jace Peterson,ARI,5,6,6,8,10,16,24
Levi Jordan,CIN,5,6,6,8,10,16,24
Matthew Batten,SD,5,6,6,8,10,16,24
Paolo Espino,TOR,5,6,6,8,10,16,24
Ryan Loutos,STL,5,6,6,8,10,16,24
Sam Haggerty,SEA,5,6,6,8,10,16,24
Cade Marlowe,SEA,4,4,5,6,8,12,18
Caleb Boushley,MIN,4,4,5,6,8,12,18
Gavin Hollowell,CHC,4,4,5,6,8,12,18
Jake Eder,CHW,4,4,5,6,8,12,18
Joe Jacques,ARI,4,4,5,6,8,12,18
Marc Church,TEX,4,4,5,6,8,12,18
Miguel Diaz,HOU,4,4,5,6,8,12,18
Orlando Ribalta,WAS,4,4,5,6,8,12,18
Samad Taylor,SEA,4,4,5,6,8,12,18
Taylor Trammell,LAD,4,4,5,6,8,12,18
Zac Kristofak,LAA,4,4,5,6,8,12,18
Alex Speas,HOU,2,3,3,4,5,8,12
Anthony Misiewicz,NYY,2,3,3,4,5,8,12
Bryce Teodosio,LAA,2,3,3,4,5,8,12
Chasen Shreve,COL,2,3,3,4,5,8,12
Eddy Alvarez,NYM,2,3,3,4,5,8,12
Edwin Rios,CIN,2,3,3,4,5,8,12
Evan Justice,COL,2,3,3,4,5,8,12
Evan Kravetz,CIN,2,3,3,4,5,8,12
Grae Kessinger,HOU,2,3,3,4,5,8,12
Matt Duffy,TEX,2,3,3,4,5,8,12
Myles Straw,CLE,2,3,3,4,5,8,12
Nacho Alvarez Jr.,ATL,2,3,3,4,5,8,12
Nick Pratto,KC,2,3,3,4,5,8,12
Victor Mederos,LAA,2,3,3,4,5,8,12
Vinny Capra,MIL,2,3,3,4,5,8,12
Andrew Saalfrank,ARI,1,1,2,2,3,4,6
CJ Alexander,KC,1,1,2,2,3,4,6
Ian Gibaut,CIN,1,1,2,2,3,4,6
Jair Camargo,MIN,1,1,2,2,3,4,6
James Meeker,MIL,1,1,2,2,3,4,6
Jonathan Bermudez,MIA,1,1,2,2,3,4,6
Jose Devers,MIA,1,1,2,2,3,4,6
Kameron Misner,TB,1,1,2,2,3,4,6
Kevin Alcantara,CHC,1,1,2,2,3,4,6
Lucas Gilbreath,COL,1,1,2,2,3,4,6
Orelvis Martinez,TOR,1,1,2,2,3,4,6
Rob Brantly,TB,1,1,2,2,3,4,6
Tony Kemp,BAL,1,1,2,2,3,4,6
Austin Pruitt,TEX,0,0,0,0,0,0,0
Brewer Hicklen,MIL,0,0,0,0,0,0,0
Cooper Hummel,HOU,0,0,0,0,0,0,0
Daniel Johnson,BAL,0,0,0,0,0,0,0
Grant Koch,PIT,0,0,0,0,0,0,0
